date,year,quarter,revenue,sales,expenditure,profit,profit_margin
2021-01-01,2021,Q1,42230,33436,29756,12474,29.54
2021-01-02,2021,Q1,27764,22995,28537,-773,-2.78
2021-01-03,2021,Q1,19454,17366,31783,-12329,-63.38
2021-01-04,2021,Q1,44950,37180,32748,12202,27.15
2021-01-05,2021,Q1,47315,42421,28959,18356,38.8
2021-01-06,2021,Q1,44914,49218,34480,10434,23.23
2021-01-07,2021,Q1,45270,49131,31987,13283,29.34
2021-01-08,2021,Q1,35646,31271,29816,5830,16.36
2021-01-09,2021,Q1,25302,23623,29669,-4367,-17.26
2021-01-10,2021,Q1,25421,25658,32943,-7522,-29.59
2021-01-11,2021,Q1,47832,50798,32663,15169,31.71
2021-01-12,2021,Q1,35664,28454,30036,5628,15.78
2021-01-13,2021,Q1,46021,43271,30842,15179,32.98
2021-01-14,2021,Q1,36238,32765,30005,6233,17.2
2021-01-15,2021,Q1,38390,35775,31560,6830,17.79
2021-01-16,2021,Q1,20252,21906,31009,-10757,-53.12
2021-01-17,2021,Q1,28762,30467,51279,-22517,-78.29
2021-01-18,2021,Q1,40591,37323,29052,11539,28.43
2021-01-19,2021,Q1,47261,53079,31503,15758,33.34
2021-01-20,2021,Q1,45928,42811,32186,13742,29.92
2021-01-21,2021,Q1,40630,45295,28353,12277,30.22
2021-01-22,2021,Q1,46865,55754,30287,16578,35.37
2021-01-23,2021,Q1,28290,23568,28786,-496,-1.75
2021-01-24,2021,Q1,20432,20330,30019,-9587,-46.92
2021-01-25,2021,Q1,35388,36770,29617,5771,16.31
2021-01-26,2021,Q1,42398,41420,29112,13286,31.34
2021-01-27,2021,Q1,41412,35907,28797,12615,30.46
2021-01-28,2021,Q1,46486,50891,29849,16637,35.79
2021-01-29,2021,Q1,34116,40343,31327,2789,8.18
2021-01-30,2021,Q1,21027,17515,31018,-9991,-47.52
2021-01-31,2021,Q1,25664,29404,30886,-5222,-20.35
2021-02-01,2021,Q1,35978,31357,31007,4971,13.82
2021-02-02,2021,Q1,46772,47359,31817,14955,31.97
2021-02-03,2021,Q1,45376,56186,33696,11680,25.74
2021-02-04,2021,Q1,35419,32515,30737,4682,13.22
2021-02-05,2021,Q1,44545,43406,34381,10164,22.82
2021-02-06,2021,Q1,26096,22035,34452,-8356,-32.02
2021-02-07,2021,Q1,26380,21889,31517,-5137,-19.47
2021-02-08,2021,Q1,47372,38177,32098,15274,32.24
2021-02-09,2021,Q1,33918,38217,32095,1823,5.37
2021-02-10,2021,Q1,41338,43528,29636,11702,28.31
2021-02-11,2021,Q1,38332,40145,30341,7991,20.85
2021-02-12,2021,Q1,39332,49514,28811,10521,26.75
2021-02-13,2021,Q1,28159,33679,30678,-2519,-8.95
2021-02-14,2021,Q1,25953,28433,78816,-52863,-203.69
2021-02-15,2021,Q1,42614,48263,29077,13537,31.77
2021-02-16,2021,Q1,36357,38705,29632,6725,18.5
2021-02-17,2021,Q1,39816,47873,28931,10885,27.34
2021-02-18,2021,Q1,32056,36019,30000,2056,6.41
2021-02-19,2021,Q1,38842,29897,33913,4929,12.69
2021-02-20,2021,Q1,27212,27120,29152,-1940,-7.13
2021-02-21,2021,Q1,26842,31940,29673,-2831,-10.55
2021-02-22,2021,Q1,44481,50835,32260,12221,27.47
2021-02-23,2021,Q1,45833,56259,33902,11931,26.03
2021-02-24,2021,Q1,37314,45066,33793,3521,9.44
2021-02-25,2021,Q1,44597,39005,33759,10838,24.3
2021-02-26,2021,Q1,39364,37368,29783,9581,24.34
2021-02-27,2021,Q1,22351,26804,30108,-7757,-34.71
2021-02-28,2021,Q1,28619,30308,29076,-457,-1.6
2021-03-01,2021,Q1,59250,51589,31087,28163,47.53
2021-03-02,2021,Q1,52124,51761,31982,20142,38.64
2021-03-03,2021,Q1,40033,47027,32882,7151,17.86
2021-03-04,2021,Q1,47284,39793,30430,16854,35.64
2021-03-05,2021,Q1,54395,49095,30922,23473,43.15
2021-03-06,2021,Q1,25527,25803,32617,-7090,-27.77
2021-03-07,2021,Q1,27611,26734,30157,-2546,-9.22
2021-03-08,2021,Q1,53094,52047,29696,23398,44.07
2021-03-09,2021,Q1,55920,46516,31597,24323,43.5
2021-03-10,2021,Q1,56368,63102,29765,26603,47.2
2021-03-11,2021,Q1,44896,46004,28808,16088,35.83
2021-03-12,2021,Q1,79032,85190,29887,49145,62.18
2021-03-13,2021,Q1,33240,27799,29458,3782,11.38
2021-03-14,2021,Q1,24602,22904,31225,-6623,-26.92
2021-03-15,2021,Q1,59757,64830,33965,25792,43.16
2021-03-16,2021,Q1,50095,56990,34002,16093,32.12
2021-03-17,2021,Q1,45183,41173,33174,12009,26.58
2021-03-18,2021,Q1,45491,36992,30061,15430,33.92
2021-03-19,2021,Q1,42767,38910,32800,9967,23.31
2021-03-20,2021,Q1,30511,28618,30996,-485,-1.59
2021-03-21,2021,Q1,32346,37943,63798,-31452,-97.24
2021-03-22,2021,Q1,47799,57143,31740,16059,33.6
2021-03-23,2021,Q1,57956,56373,31409,26547,45.81
2021-03-24,2021,Q1,55962,63056,34143,21819,38.99
2021-03-25,2021,Q1,58138,61257,28878,29260,50.33
2021-03-26,2021,Q1,43634,38766,31214,12420,28.46
2021-03-27,2021,Q1,27339,32020,33609,-6270,-22.93
2021-03-28,2021,Q1,24625,28274,28782,-4157,-16.88
2021-03-29,2021,Q1,40620,37752,32264,8356,20.57
2021-03-30,2021,Q1,42287,49686,29964,12323,29.14
2021-03-31,2021,Q1,59274,66241,29381,29893,50.43
2021-04-01,2021,Q2,58577,62815,30714,27863,47.57
2021-04-02,2021,Q2,51841,57186,32742,19099,36.84
2021-04-03,2021,Q2,33666,37903,28608,5058,15.02
2021-04-04,2021,Q2,24827,25010,30996,-6169,-24.85
2021-04-05,2021,Q2,47243,54422,29313,17930,37.95
2021-04-06,2021,Q2,53009,57794,33230,19779,37.31
2021-04-07,2021,Q2,51849,46937,34238,17611,33.97
2021-04-08,2021,Q2,55009,57496,30469,24540,44.61
2021-04-09,2021,Q2,49750,45728,30111,19639,39.48
2021-04-10,2021,Q2,30669,29919,29870,799,2.61
2021-04-11,2021,Q2,26883,27189,60456,-33573,-124.89
2021-04-12,2021,Q2,53835,50066,31331,22504,41.8
2021-04-13,2021,Q2,54918,52239,30056,24862,45.27
2021-04-14,2021,Q2,43851,37311,33151,10700,24.4
2021-04-15,2021,Q2,49683,56726,31655,18028,36.29
2021-04-16,2021,Q2,43882,37845,28439,15443,35.19
2021-04-17,2021,Q2,35691,37172,29145,6546,18.34
2021-04-18,2021,Q2,34472,35384,31124,3348,9.71
2021-04-19,2021,Q2,58821,60174,30874,27947,47.51
2021-04-20,2021,Q2,41072,35530,30264,10808,26.31
2021-04-21,2021,Q2,55288,59315,29771,25517,46.15
2021-04-22,2021,Q2,48854,58631,30273,18581,38.03
2021-04-23,2021,Q2,54801,62724,29679,25122,45.84
2021-04-24,2021,Q2,26085,20574,31188,-5103,-19.56
2021-04-25,2021,Q2,26777,29582,31210,-4433,-16.56
2021-04-26,2021,Q2,55756,59488,34232,21524,38.6
2021-04-27,2021,Q2,52952,63614,28799,24153,45.61
2021-04-28,2021,Q2,54979,55306,29133,25846,47.01
2021-04-29,2021,Q2,58853,58827,28856,29997,50.97
2021-04-30,2021,Q2,46446,40099,34410,12036,25.91
2021-05-01,2021,Q2,35409,43216,30047,5362,15.14
2021-05-02,2021,Q2,29646,32750,29493,153,0.52
2021-05-03,2021,Q2,49834,41052,30449,19385,38.9
2021-05-04,2021,Q2,46596,49142,34304,12292,26.38
2021-05-05,2021,Q2,49096,44650,34462,14634,29.81
2021-05-06,2021,Q2,59762,63801,30953,28809,48.21
2021-05-07,2021,Q2,55128,59398,29632,25496,46.25
2021-05-08,2021,Q2,29257,30381,34480,-5223,-17.85
2021-05-09,2021,Q2,25900,26564,28937,-3037,-11.73
2021-05-10,2021,Q2,49228,43080,31489,17739,36.03
2021-05-11,2021,Q2,45468,54031,29885,15583,34.27
2021-05-12,2021,Q2,58437,60853,33793,24644,42.17
2021-05-13,2021,Q2,48298,56731,33519,14779,30.6
2021-05-14,2021,Q2,51738,61998,29286,22452,43.4
2021-05-15,2021,Q2,30623,31015,30377,246,0.8
2021-05-16,2021,Q2,30861,28331,28624,2237,7.25
2021-05-17,2021,Q2,56228,54544,33520,22708,40.39
2021-05-18,2021,Q2,40740,41145,33829,6911,16.96
2021-05-19,2021,Q2,50519,50753,30932,19587,38.77
2021-05-20,2021,Q2,49389,57711,32714,16675,33.76
2021-05-21,2021,Q2,57046,64462,30344,26702,46.81
2021-05-22,2021,Q2,34468,26857,32326,2142,6.21
2021-05-23,2021,Q2,32961,30801,32342,619,1.88
2021-05-24,2021,Q2,53880,59733,33365,20515,38.08
2021-05-25,2021,Q2,42911,43732,33342,9569,22.3
2021-05-26,2021,Q2,57416,58606,34100,23316,40.61
2021-05-27,2021,Q2,45079,38672,33419,11660,25.87
2021-05-28,2021,Q2,43159,41502,32051,11108,25.74
2021-05-29,2021,Q2,27001,29806,30773,-3772,-13.97
2021-05-30,2021,Q2,30863,33352,30209,654,2.12
2021-05-31,2021,Q2,45489,47556,33041,12448,27.36
2021-06-01,2021,Q2,54928,62443,33382,21546,39.23
2021-06-02,2021,Q2,58005,61890,32891,25114,43.3
2021-06-03,2021,Q2,57821,68133,30296,27525,47.6
2021-06-04,2021,Q2,60111,49226,33059,27052,45.0
2021-06-05,2021,Q2,33520,39964,34104,-584,-1.74
2021-06-06,2021,Q2,37285,38148,33053,4232,11.35
2021-06-07,2021,Q2,65183,58420,33768,31415,48.2
2021-06-08,2021,Q2,65279,72249,78495,-13216,-20.25
2021-06-09,2021,Q2,52108,55935,30750,21358,40.99
2021-06-10,2021,Q2,58846,58870,34291,24555,41.73
2021-06-11,2021,Q2,58248,61183,32766,25482,43.75
2021-06-12,2021,Q2,26998,23091,29081,-2083,-7.72
2021-06-13,2021,Q2,31530,31246,32737,-1207,-3.83
2021-06-14,2021,Q2,59985,70305,33602,26383,43.98
2021-06-15,2021,Q2,50154,52445,31151,19003,37.89
2021-06-16,2021,Q2,65580,64594,32412,33168,50.58
2021-06-17,2021,Q2,65300,79525,28927,36373,55.7
2021-06-18,2021,Q2,65364,52720,34579,30785,47.1
2021-06-19,2021,Q2,37353,38492,33472,3881,10.39
2021-06-20,2021,Q2,36810,37371,34549,2261,6.14
2021-06-21,2021,Q2,61567,53864,29180,32387,52.6
2021-06-22,2021,Q2,56954,44845,29148,27806,48.82
2021-06-23,2021,Q2,45398,43845,32090,13308,29.31
2021-06-24,2021,Q2,57532,65326,32501,25031,43.51
2021-06-25,2021,Q2,44685,55458,31035,13650,30.55
2021-06-26,2021,Q2,32255,36740,29284,2971,9.21
2021-06-27,2021,Q2,34126,36581,32113,2013,5.9
2021-06-28,2021,Q2,53464,57428,32474,20990,39.26
2021-06-29,2021,Q2,63040,63654,30957,32083,50.89
2021-06-30,2021,Q2,60051,54506,29955,30096,50.12
2021-07-01,2021,Q3,54433,43644,31070,23363,42.92
2021-07-02,2021,Q3,46862,40377,31888,14974,31.95
2021-07-03,2021,Q3,37931,44280,34119,3812,10.05
2021-07-04,2021,Q3,30524,25703,29324,1200,3.93
2021-07-05,2021,Q3,51702,50829,30104,21598,41.77
2021-07-06,2021,Q3,56341,63127,32602,23739,42.13
2021-07-07,2021,Q3,58472,60029,30071,28401,48.57
2021-07-08,2021,Q3,51722,43520,32491,19231,37.18
2021-07-09,2021,Q3,65379,54869,30720,34659,53.01
2021-07-10,2021,Q3,30513,29621,32106,-1593,-5.22
2021-07-11,2021,Q3,36358,28562,31141,5217,14.35
2021-07-12,2021,Q3,53112,47127,30524,22588,42.53
2021-07-13,2021,Q3,57048,56557,29739,27309,47.87
2021-07-14,2021,Q3,48497,58663,33164,15333,31.62
2021-07-15,2021,Q3,54942,51437,31705,23237,42.29
2021-07-16,2021,Q3,58697,54704,33024,25673,43.74
2021-07-17,2021,Q3,27427,25196,30897,-3470,-12.65
2021-07-18,2021,Q3,31746,36430,34319,-2573,-8.1
2021-07-19,2021,Q3,51960,48648,31094,20866,40.16
2021-07-20,2021,Q3,63151,67428,33258,29893,47.34
2021-07-21,2021,Q3,55673,50206,30561,25112,45.11
2021-07-22,2021,Q3,47249,38772,29443,17806,37.69
2021-07-23,2021,Q3,45657,54588,31272,14385,31.51
2021-07-24,2021,Q3,35390,41381,34565,825,2.33
2021-07-25,2021,Q3,30573,29743,32327,-1754,-5.74
2021-07-26,2021,Q3,51742,42764,28586,23156,44.75
2021-07-27,2021,Q3,58182,66452,32092,26090,44.84
2021-07-28,2021,Q3,64993,67936,34077,30916,47.57
2021-07-29,2021,Q3,57310,59965,31188,26122,45.58
2021-07-30,2021,Q3,65612,55502,28596,37016,56.42
2021-07-31,2021,Q3,33317,34306,34133,-816,-2.45
2021-08-01,2021,Q3,35361,29409,30458,4903,13.87
2021-08-02,2021,Q3,52504,48958,34425,18079,34.43
2021-08-03,2021,Q3,45793,50823,30304,15489,33.82
2021-08-04,2021,Q3,46836,48640,31871,14965,31.95
2021-08-05,2021,Q3,46811,52871,34632,12179,26.02
2021-08-06,2021,Q3,58750,56109,30295,28455,48.43
2021-08-07,2021,Q3,36513,33615,29326,7187,19.68
2021-08-08,2021,Q3,33101,34430,31667,1434,4.33
2021-08-09,2021,Q3,57596,57767,29489,28107,48.8
2021-08-10,2021,Q3,63858,66336,30645,33213,52.01
2021-08-11,2021,Q3,57433,65025,29824,27609,48.07
2021-08-12,2021,Q3,61256,68977,32623,28633,46.74
2021-08-13,2021,Q3,60927,67724,30987,29940,49.14
2021-08-14,2021,Q3,34381,37741,31377,3004,8.74
2021-08-15,2021,Q3,35790,34665,28878,6912,19.31
2021-08-16,2021,Q3,55293,60058,34086,21207,38.35
2021-08-17,2021,Q3,64470,61630,30705,33765,52.37
2021-08-18,2021,Q3,48939,43569,32852,16087,32.87
2021-08-19,2021,Q3,44842,52184,33585,11257,25.1
2021-08-20,2021,Q3,57537,63660,29708,27829,48.37
2021-08-21,2021,Q3,34437,34301,29847,4590,13.33
2021-08-22,2021,Q3,34834,34947,33621,1213,3.48
2021-08-23,2021,Q3,57903,60944,63307,-5404,-9.33
2021-08-24,2021,Q3,53164,54311,34490,18674,35.13
2021-08-25,2021,Q3,55161,66292,30809,24352,44.15
2021-08-26,2021,Q3,65582,56259,33317,32265,49.2
2021-08-27,2021,Q3,57821,65607,30444,27377,47.35
2021-08-28,2021,Q3,37138,33213,31277,5861,15.78
2021-08-29,2021,Q3,37111,31471,31233,5878,15.84
2021-08-30,2021,Q3,48388,41234,31596,16792,34.7
2021-08-31,2021,Q3,49572,52908,30598,18974,38.28
2021-09-01,2021,Q3,46638,39109,33953,12685,27.2
2021-09-02,2021,Q3,47732,56755,31484,16248,34.04
2021-09-03,2021,Q3,56022,58537,32145,23877,42.62
2021-09-04,2021,Q3,27854,23548,30280,-2426,-8.71
2021-09-05,2021,Q3,32277,28970,33831,-1554,-4.81
2021-09-06,2021,Q3,45491,56654,28822,16669,36.64
2021-09-07,2021,Q3,56021,62759,29249,26772,47.79
2021-09-08,2021,Q3,40695,34587,30657,10038,24.67
2021-09-09,2021,Q3,52101,58338,30693,21408,41.09
2021-09-10,2021,Q3,50589,49251,29922,20667,40.85
2021-09-11,2021,Q3,29988,28808,29999,-11,-0.04
2021-09-12,2021,Q3,35956,34241,31444,4512,12.55
2021-09-13,2021,Q3,49040,56548,28903,20137,41.06
2021-09-14,2021,Q3,46391,41664,31765,14626,31.53
2021-09-15,2021,Q3,54236,64381,33350,20886,38.51
2021-09-16,2021,Q3,44019,38754,28515,15504,35.22
2021-09-17,2021,Q3,56073,57872,28893,27180,48.47
2021-09-18,2021,Q3,32626,33848,33537,-911,-2.79
2021-09-19,2021,Q3,31708,31633,30520,1188,3.75
2021-09-20,2021,Q3,52795,48227,31075,21720,41.14
2021-09-21,2021,Q3,42483,35359,30382,12101,28.48
2021-09-22,2021,Q3,58818,70465,29928,28890,49.12
2021-09-23,2021,Q3,42503,39281,31516,10987,25.85
2021-09-24,2021,Q3,43083,46829,32162,10921,25.35
2021-09-25,2021,Q3,33902,26256,32391,1511,4.46
2021-09-26,2021,Q3,33203,32541,31487,1716,5.17
2021-09-27,2021,Q3,59133,60519,32665,26468,44.76
2021-09-28,2021,Q3,41198,40139,29635,11563,28.07
2021-09-29,2021,Q3,54367,61605,34494,19873,36.55
2021-09-30,2021,Q3,51233,47366,30035,21198,41.38
2021-10-01,2021,Q4,45804,44185,29914,15890,34.69
2021-10-02,2021,Q4,27929,28257,33157,-5228,-18.72
2021-10-03,2021,Q4,29985,26368,34304,-4319,-14.4
2021-10-04,2021,Q4,44302,39821,31467,12835,28.97
2021-10-05,2021,Q4,49411,51876,31064,18347,37.13
2021-10-06,2021,Q4,55277,51792,31942,23335,42.21
2021-10-07,2021,Q4,41470,42638,30112,11358,27.39
2021-10-08,2021,Q4,42376,49893,33357,9019,21.28
2021-10-09,2021,Q4,33059,29105,31500,1559,4.72
2021-10-10,2021,Q4,27996,27582,32169,-4173,-14.91
2021-10-11,2021,Q4,52261,47423,33007,19254,36.84
2021-10-12,2021,Q4,56565,58492,30238,26327,46.54
2021-10-13,2021,Q4,53476,64274,33369,20107,37.6
2021-10-14,2021,Q4,40532,41993,33282,7250,17.89
2021-10-15,2021,Q4,54428,54393,32312,22116,40.63
2021-10-16,2021,Q4,25773,26341,34323,-8550,-33.17
2021-10-17,2021,Q4,27764,24348,30935,-3171,-11.42
2021-10-18,2021,Q4,57456,60123,29219,28237,49.15
2021-10-19,2021,Q4,53244,52784,29441,23803,44.71
2021-10-20,2021,Q4,47085,53361,32402,14683,31.18
2021-10-21,2021,Q4,43845,39628,29766,14079,32.11
2021-10-22,2021,Q4,45780,41248,30347,15433,33.71
2021-10-23,2021,Q4,33544,29350,32612,932,2.78
2021-10-24,2021,Q4,33820,41187,30179,3641,10.77
2021-10-25,2021,Q4,46927,44728,31368,15559,33.16
2021-10-26,2021,Q4,58660,60968,32228,26432,45.06
2021-10-27,2021,Q4,53396,54804,28680,24716,46.29
2021-10-28,2021,Q4,42010,44256,31817,10193,24.26
2021-10-29,2021,Q4,58700,67432,29606,29094,49.56
2021-10-30,2021,Q4,31750,35414,31967,-217,-0.68
2021-10-31,2021,Q4,35240,39730,33908,1332,3.78
2021-11-01,2021,Q4,77926,74680,34250,43676,56.05
2021-11-02,2021,Q4,74795,60521,29025,45770,61.19
2021-11-03,2021,Q4,77716,79013,34262,43454,55.91
2021-11-04,2021,Q4,57013,46553,31241,25772,45.2
2021-11-05,2021,Q4,71152,79965,33120,38032,53.45
2021-11-06,2021,Q4,45193,51182,28896,16297,36.06
2021-11-07,2021,Q4,33393,30254,29992,3401,10.18
2021-11-08,2021,Q4,76804,72295,28422,48382,62.99
2021-11-09,2021,Q4,53615,44549,30904,22711,42.36
2021-11-10,2021,Q4,70292,62491,34121,36171,51.46
2021-11-11,2021,Q4,57697,47532,33060,24637,42.7
2021-11-12,2021,Q4,66280,65752,32533,33747,50.92
2021-11-13,2021,Q4,42973,47321,31164,11809,27.48
2021-11-14,2021,Q4,40001,33146,31534,8467,21.17
2021-11-15,2021,Q4,60531,58681,29644,30887,51.03
2021-11-16,2021,Q4,65269,72986,31583,33686,51.61
2021-11-17,2021,Q4,64021,73485,30844,33177,51.82
2021-11-18,2021,Q4,67036,53990,28751,38285,57.11
2021-11-19,2021,Q4,53794,60171,30925,22869,42.51
2021-11-20,2021,Q4,46461,48780,34604,11857,25.52
2021-11-21,2021,Q4,45345,43876,32519,12826,28.29
2021-11-22,2021,Q4,61042,53389,31681,29361,48.1
2021-11-23,2021,Q4,52090,41295,32593,19497,37.43
2021-11-24,2021,Q4,73407,64978,30086,43321,59.01
2021-11-25,2021,Q4,54933,61234,33176,21757,39.61
2021-11-26,2021,Q4,57358,45953,32116,25242,44.01
2021-11-27,2021,Q4,42752,39989,29718,13034,30.49
2021-11-28,2021,Q4,39060,36896,32958,6102,15.62
2021-11-29,2021,Q4,69485,63221,29252,40233,57.9
2021-11-30,2021,Q4,59813,51520,33892,25921,43.34
2021-12-01,2021,Q4,63107,65971,34281,28826,45.68
2021-12-02,2021,Q4,60287,56225,30721,29566,49.04
2021-12-03,2021,Q4,74082,69592,33426,40656,54.88
2021-12-04,2021,Q4,46297,45625,29880,16417,35.46
2021-12-05,2021,Q4,45586,49800,32914,12672,27.8
2021-12-06,2021,Q4,69515,75080,29535,39980,57.51
2021-12-07,2021,Q4,66530,68419,30447,36083,54.24
2021-12-08,2021,Q4,76366,87018,34647,41719,54.63
2021-12-09,2021,Q4,67714,62189,31828,35886,53.0
2021-12-10,2021,Q4,65874,60683,31580,34294,52.06
2021-12-11,2021,Q4,46508,47501,34110,12398,26.66
2021-12-12,2021,Q4,39975,34260,29992,9983,24.97
2021-12-13,2021,Q4,62857,53196,30742,32115,51.09
2021-12-14,2021,Q4,69019,72323,33526,35493,51.42
2021-12-15,2021,Q4,64755,57818,29416,35339,54.57
2021-12-16,2021,Q4,75839,78210,28720,47119,62.13
2021-12-17,2021,Q4,76574,83886,30948,45626,59.58
2021-12-18,2021,Q4,42231,33958,30701,11530,27.3
2021-12-19,2021,Q4,40817,40493,28391,12426,30.44
2021-12-20,2021,Q4,65764,62695,28457,37307,56.73
2021-12-21,2021,Q4,72960,81581,28956,44004,60.31
2021-12-22,2021,Q4,65687,72248,30850,34837,53.03
2021-12-23,2021,Q4,66690,77580,32659,34031,51.03
2021-12-24,2021,Q4,74313,78694,30739,43574,58.64
2021-12-25,2021,Q4,31347,27226,31083,264,0.84
2021-12-26,2021,Q4,44584,37473,28618,15966,35.81
2021-12-27,2021,Q4,75076,70969,28818,46258,61.61
2021-12-28,2021,Q4,66651,56521,30331,36320,54.49
2021-12-29,2021,Q4,71558,76856,28834,42724,59.71
2021-12-30,2021,Q4,73700,73225,30439,43261,58.7
2021-12-31,2021,Q4,77700,84673,34488,43212,55.61
2022-01-01,2022,Q1,31338,30129,39520,-8182,-26.11
2022-01-02,2022,Q1,22407,21379,36156,-13749,-61.36
2022-01-03,2022,Q1,44746,48732,33223,11523,25.75
2022-01-04,2022,Q1,49921,40137,37758,12163,24.36
2022-01-05,2022,Q1,42626,34140,34835,7791,18.28
2022-01-06,2022,Q1,39238,34155,36621,2617,6.67
2022-01-07,2022,Q1,43312,36617,34952,8360,19.3
2022-01-08,2022,Q1,26361,22863,39160,-12799,-48.55
2022-01-09,2022,Q1,23952,21985,34784,-10832,-45.22
2022-01-10,2022,Q1,44798,43315,33159,11639,25.98
2022-01-11,2022,Q1,48300,48586,33377,14923,30.9
2022-01-12,2022,Q1,42912,46342,34990,7922,18.46
2022-01-13,2022,Q1,52614,60316,34925,17689,33.62
2022-01-14,2022,Q1,42580,52859,34714,7866,18.47
2022-01-15,2022,Q1,28437,25190,38518,-10081,-35.45
2022-01-16,2022,Q1,28304,29482,37541,-9237,-32.63
2022-01-17,2022,Q1,45293,48766,34713,10580,23.36
2022-01-18,2022,Q1,51440,49567,37191,14249,27.7
2022-01-19,2022,Q1,49960,53362,39780,10180,20.38
2022-01-20,2022,Q1,46121,54909,36541,9580,20.77
2022-01-21,2022,Q1,53277,54810,33218,20059,37.65
2022-01-22,2022,Q1,25999,26273,39728,-13729,-52.81
2022-01-23,2022,Q1,30389,35799,32678,-2289,-7.53
2022-01-24,2022,Q1,46345,48197,35832,10513,22.68
2022-01-25,2022,Q1,47630,46900,32780,14850,31.18
2022-01-26,2022,Q1,54495,48158,33628,20867,38.29
2022-01-27,2022,Q1,40606,40232,35777,4829,11.89
2022-01-28,2022,Q1,42324,45744,38754,3570,8.43
2022-01-29,2022,Q1,23894,27788,33866,-9972,-41.73
2022-01-30,2022,Q1,32661,28880,33938,-1277,-3.91
2022-01-31,2022,Q1,37337,37859,36893,444,1.19
2022-02-01,2022,Q1,40586,46061,33055,7531,18.56
2022-02-02,2022,Q1,40240,37280,34503,5737,14.26
2022-02-03,2022,Q1,48559,51003,36855,11704,24.1
2022-02-04,2022,Q1,48159,55319,34757,13402,27.83
2022-02-05,2022,Q1,23558,19568,33928,-10370,-44.02
2022-02-06,2022,Q1,26697,22564,33948,-7251,-27.16
2022-02-07,2022,Q1,48672,58725,36149,12523,25.73
2022-02-08,2022,Q1,45098,36523,32671,12427,27.56
2022-02-09,2022,Q1,54534,54625,37563,16971,31.12
2022-02-10,2022,Q1,45792,36358,38116,7676,16.76
2022-02-11,2022,Q1,46691,40321,37982,8709,18.65
2022-02-12,2022,Q1,23329,20271,38567,-15238,-65.32
2022-02-13,2022,Q1,22539,24626,39773,-17234,-76.46
2022-02-14,2022,Q1,50624,48850,35860,14764,29.16
2022-02-15,2022,Q1,44878,55226,34319,10559,23.53
2022-02-16,2022,Q1,43251,47519,33805,9446,21.84
2022-02-17,2022,Q1,40607,32950,34638,5969,14.7
2022-02-18,2022,Q1,49754,44501,38818,10936,21.98
2022-02-19,2022,Q1,23131,28195,39258,-16127,-69.72
2022-02-20,2022,Q1,23480,26244,37756,-14276,-60.8
2022-02-21,2022,Q1,49242,49414,34549,14693,29.84
2022-02-22,2022,Q1,48458,53554,36338,12120,25.01
2022-02-23,2022,Q1,43590,50552,32620,10970,25.17
2022-02-24,2022,Q1,50249,50224,35197,15052,29.95
2022-02-25,2022,Q1,40808,38516,34548,6260,15.34
2022-02-26,2022,Q1,28460,29170,35092,-6632,-23.3
2022-02-27,2022,Q1,23179,25706,33502,-10323,-44.54
2022-02-28,2022,Q1,36812,42259,37591,-779,-2.12
2022-03-01,2022,Q1,49656,56934,37344,12312,24.79
2022-03-02,2022,Q1,66787,57251,34815,31972,47.87
2022-03-03,2022,Q1,61076,62756,36056,25020,40.97
2022-03-04,2022,Q1,61639,50509,38522,23117,37.5
2022-03-05,2022,Q1,29424,24087,37896,-8472,-28.79
2022-03-06,2022,Q1,39757,34915,38059,1698,4.27
2022-03-07,2022,Q1,49285,47434,37311,11974,24.3
2022-03-08,2022,Q1,60445,51556,37576,22869,37.83
2022-03-09,2022,Q1,48310,53664,35384,12926,26.76
2022-03-10,2022,Q1,49216,42961,36611,12605,25.61
2022-03-11,2022,Q1,63916,71178,37372,26544,41.53
2022-03-12,2022,Q1,34631,37285,32997,1634,4.72
2022-03-13,2022,Q1,34429,29094,36905,-2476,-7.19
2022-03-14,2022,Q1,68698,77654,38839,29859,43.46
2022-03-15,2022,Q1,61707,71290,52608,9099,14.75
2022-03-16,2022,Q1,50962,62249,35485,15477,30.37
2022-03-17,2022,Q1,63643,61094,37243,26400,41.48
2022-03-18,2022,Q1,47922,41529,39661,8261,17.24
2022-03-19,2022,Q1,35692,40041,37262,-1570,-4.4
2022-03-20,2022,Q1,40757,35563,39301,1456,3.57
2022-03-21,2022,Q1,47265,51201,52867,-5602,-11.85
2022-03-22,2022,Q1,49768,58921,38275,11493,23.09
2022-03-23,2022,Q1,48919,53161,39024,9895,20.23
2022-03-24,2022,Q1,64563,56115,37763,26800,41.51
2022-03-25,2022,Q1,56469,53307,36709,19760,34.99
2022-03-26,2022,Q1,29020,30543,34257,-5237,-18.05
2022-03-27,2022,Q1,39508,35370,35377,4131,10.46
2022-03-28,2022,Q1,65722,69889,37968,27754,42.23
2022-03-29,2022,Q1,55573,59086,33166,22407,40.32
2022-03-30,2022,Q1,66744,59954,39712,27032,40.5
2022-03-31,2022,Q1,77138,72848,34973,42165,54.66
2022-04-01,2022,Q2,58967,55008,35963,23004,39.01
2022-04-02,2022,Q2,58465,53398,38112,20353,34.81
2022-04-03,2022,Q2,53181,51609,38957,14224,26.75
2022-04-04,2022,Q2,65527,68651,36441,29086,44.39
2022-04-05,2022,Q2,47377,57996,33276,14101,29.76
2022-04-06,2022,Q2,57954,61811,39663,18291,31.56
2022-04-07,2022,Q2,49070,52996,36716,12354,25.18
2022-04-08,2022,Q2,51445,45665,38404,13041,25.35
2022-04-09,2022,Q2,31989,27834,34071,-2082,-6.51
2022-04-10,2022,Q2,29744,25663,35547,-5803,-19.51
2022-04-11,2022,Q2,50775,45780,33471,17304,34.08
2022-04-12,2022,Q2,65006,66901,38658,26348,40.53
2022-04-13,2022,Q2,51709,48790,37508,14201,27.46
2022-04-14,2022,Q2,46714,44712,38022,8692,18.61
2022-04-15,2022,Q2,64489,52503,38618,25871,40.12
2022-04-16,2022,Q2,38966,37456,37273,1693,4.34
2022-04-17,2022,Q2,38815,30023,39141,-326,-0.84
2022-04-18,2022,Q2,66816,74344,32911,33905,50.74
2022-04-19,2022,Q2,59199,66114,32816,26383,44.57
2022-04-20,2022,Q2,50938,43582,39002,11936,23.43
2022-04-21,2022,Q2,51653,47002,36592,15061,29.16
2022-04-22,2022,Q2,49156,44910,36412,12744,25.93
2022-04-23,2022,Q2,38568,47418,35204,3364,8.72
2022-04-24,2022,Q2,40194,39783,33905,6289,15.65
2022-04-25,2022,Q2,66602,70755,39786,26816,40.26
2022-04-26,2022,Q2,68990,78788,37361,31629,45.85
2022-04-27,2022,Q2,67096,57916,34192,32904,49.04
2022-04-28,2022,Q2,54160,63632,33878,20282,37.45
2022-04-29,2022,Q2,62045,68907,37678,24367,39.27
2022-04-30,2022,Q2,35370,32469,38989,-3619,-10.23
2022-05-01,2022,Q2,66478,54095,34187,32291,48.57
2022-05-02,2022,Q2,50633,44085,39259,11374,22.46
2022-05-03,2022,Q2,46503,50121,38212,8291,17.83
2022-05-04,2022,Q2,68092,67506,35468,32624,47.91
2022-05-05,2022,Q2,49138,44308,38339,10799,21.98
2022-05-06,2022,Q2,50006,60531,39331,10675,21.35
2022-05-07,2022,Q2,35727,30486,37590,-1863,-5.21
2022-05-08,2022,Q2,40693,47476,39806,887,2.18
2022-05-09,2022,Q2,59854,73203,34202,25652,42.86
2022-05-10,2022,Q2,49234,52649,39719,9515,19.33
2022-05-11,2022,Q2,48040,52779,39026,9014,18.76
2022-05-12,2022,Q2,51739,41752,68677,-16938,-32.74
2022-05-13,2022,Q2,55652,47809,38990,16662,29.94
2022-05-14,2022,Q2,39037,43885,38095,942,2.41
2022-05-15,2022,Q2,38628,29910,34494,4134,10.7
2022-05-16,2022,Q2,66422,54972,39426,26996,40.64
2022-05-17,2022,Q2,68661,81085,35727,32934,47.97
2022-05-18,2022,Q2,55986,45211,39662,16324,29.16
2022-05-19,2022,Q2,67288,69465,34757,32531,48.35
2022-05-20,2022,Q2,58642,55826,32630,26012,44.36
2022-05-21,2022,Q2,36226,34492,34101,2125,5.87
2022-05-22,2022,Q2,34135,29708,36014,-1879,-5.5
2022-05-23,2022,Q2,60762,57279,35366,25396,41.8
2022-05-24,2022,Q2,56114,52515,36690,19424,34.62
2022-05-25,2022,Q2,48224,53053,35601,12623,26.18
2022-05-26,2022,Q2,47402,45363,39598,7804,16.46
2022-05-27,2022,Q2,59172,51850,35462,23710,40.07
2022-05-28,2022,Q2,35482,35976,39722,-4240,-11.95
2022-05-29,2022,Q2,33796,38539,34137,-341,-1.01
2022-05-30,2022,Q2,47802,49774,38561,9241,19.33
2022-05-31,2022,Q2,53354,59989,33233,20121,37.71
2022-06-01,2022,Q2,72272,75879,32692,39580,54.77
2022-06-02,2022,Q2,70376,57384,36707,33669,47.84
2022-06-03,2022,Q2,53135,46004,38295,14840,27.93
2022-06-04,2022,Q2,43686,40176,36746,6940,15.89
2022-06-05,2022,Q2,36477,38893,35512,965,2.65
2022-06-06,2022,Q2,68069,55658,34548,33521,49.25
2022-06-07,2022,Q2,70679,67574,38820,31859,45.08
2022-06-08,2022,Q2,56367,53132,38210,18157,32.21
2022-06-09,2022,Q2,65905,54756,39220,26685,40.49
2022-06-10,2022,Q2,63667,57772,38336,25331,39.79
2022-06-11,2022,Q2,36483,40675,36722,-239,-0.66
2022-06-12,2022,Q2,33407,26211,32968,439,1.31
2022-06-13,2022,Q2,59919,58452,39290,20629,34.43
2022-06-14,2022,Q2,62966,64445,36040,26926,42.76
2022-06-15,2022,Q2,71792,67007,33257,38535,53.68
2022-06-16,2022,Q2,72201,77989,34206,37995,52.62
2022-06-17,2022,Q2,67085,69900,39609,27476,40.96
2022-06-18,2022,Q2,32368,28983,34223,-1855,-5.73
2022-06-19,2022,Q2,41179,43625,39090,2089,5.07
2022-06-20,2022,Q2,112214,103546,37120,75094,66.92
2022-06-21,2022,Q2,75052,85764,36904,38148,50.83
2022-06-22,2022,Q2,62787,57363,34958,27829,44.32
2022-06-23,2022,Q2,74690,76746,36350,38340,51.33
2022-06-24,2022,Q2,72290,80475,34917,37373,51.7
2022-06-25,2022,Q2,37910,36227,35533,2377,6.27
2022-06-26,2022,Q2,45460,50403,37770,7690,16.92
2022-06-27,2022,Q2,62636,72634,34777,27859,44.48
2022-06-28,2022,Q2,64723,59210,37970,26753,41.33
2022-06-29,2022,Q2,73689,90333,37343,36346,49.32
2022-06-30,2022,Q2,72647,73056,35295,37352,51.42
2022-07-01,2022,Q3,53579,44605,36806,16773,31.31
2022-07-02,2022,Q3,33313,28757,36441,-3128,-9.39
2022-07-03,2022,Q3,32648,38462,39754,-7106,-21.77
2022-07-04,2022,Q3,54223,60098,33187,21036,38.8
2022-07-05,2022,Q3,58529,47950,34119,24410,41.71
2022-07-06,2022,Q3,54608,62539,33540,21068,38.58
2022-07-07,2022,Q3,61454,57881,36469,24985,40.66
2022-07-08,2022,Q3,73167,80934,59038,14129,19.31
2022-07-09,2022,Q3,43672,38784,36249,7423,17.0
2022-07-10,2022,Q3,31054,36463,36371,-5317,-17.12
2022-07-11,2022,Q3,67975,60896,36153,31822,46.81
2022-07-12,2022,Q3,73544,78744,34227,39317,53.46
2022-07-13,2022,Q3,51154,49317,37754,13400,26.2
2022-07-14,2022,Q3,66800,74959,36905,29895,44.75
2022-07-15,2022,Q3,71753,56528,35821,35932,50.08
2022-07-16,2022,Q3,41014,36854,32669,8345,20.35
2022-07-17,2022,Q3,38258,40942,35636,2622,6.85
2022-07-18,2022,Q3,66227,62192,36208,30019,45.33
2022-07-19,2022,Q3,71636,83982,35571,36065,50.34
2022-07-20,2022,Q3,73632,79022,50133,23499,31.91
2022-07-21,2022,Q3,71731,73893,33255,38476,53.64
2022-07-22,2022,Q3,53162,46681,39765,13397,25.2
2022-07-23,2022,Q3,31875,26450,34707,-2832,-8.88
2022-07-24,2022,Q3,41571,35735,32934,8637,20.78
2022-07-25,2022,Q3,54913,51461,37107,17806,32.43
2022-07-26,2022,Q3,71218,61566,39574,31644,44.43
2022-07-27,2022,Q3,72121,81974,38376,33745,46.79
2022-07-28,2022,Q3,52083,59213,35616,16467,31.62
2022-07-29,2022,Q3,67763,58412,35200,32563,48.05
2022-07-30,2022,Q3,43088,49355,39270,3818,8.86
2022-07-31,2022,Q3,31057,27573,37707,-6650,-21.41
2022-08-01,2022,Q3,65189,70080,37455,27734,42.54
2022-08-02,2022,Q3,68324,58188,34403,33921,49.65
2022-08-03,2022,Q3,60337,68919,39759,20578,34.11
2022-08-04,2022,Q3,54570,64372,38901,15669,28.71
2022-08-05,2022,Q3,56694,64327,34216,22478,39.65
2022-08-06,2022,Q3,33927,34377,35848,-1921,-5.66
2022-08-07,2022,Q3,32161,32619,33346,-1185,-3.68
2022-08-08,2022,Q3,50604,42764,37087,13517,26.71
2022-08-09,2022,Q3,55833,62349,35234,20599,36.89
2022-08-10,2022,Q3,62097,64352,36030,26067,41.98
2022-08-11,2022,Q3,53484,57389,35075,18409,34.42
2022-08-12,2022,Q3,57987,59679,32934,25053,43.2
2022-08-13,2022,Q3,41241,43131,37028,4213,10.22
2022-08-14,2022,Q3,36324,36704,37795,-1471,-4.05
2022-08-15,2022,Q3,74043,84784,38196,35847,48.41
2022-08-16,2022,Q3,74791,63853,36444,38347,51.27
2022-08-17,2022,Q3,71822,71391,39276,32546,45.31
2022-08-18,2022,Q3,69081,58150,36953,32128,46.51
2022-08-19,2022,Q3,60331,74893,38125,22206,36.81
2022-08-20,2022,Q3,45092,42619,35592,9500,21.07
2022-08-21,2022,Q3,34897,39069,37760,-2863,-8.2
2022-08-22,2022,Q3,55682,57223,35104,20578,36.96
2022-08-23,2022,Q3,67047,79369,37632,29415,43.87
2022-08-24,2022,Q3,59511,59460,37436,22075,37.09
2022-08-25,2022,Q3,71887,68014,38458,33429,46.5
2022-08-26,2022,Q3,54276,56232,38037,16239,29.92
2022-08-27,2022,Q3,34163,39540,34740,-577,-1.69
2022-08-28,2022,Q3,42716,37245,37960,4756,11.13
2022-08-29,2022,Q3,64800,59647,38389,26411,40.76
2022-08-30,2022,Q3,74040,73939,39672,34368,46.42
2022-08-31,2022,Q3,50928,46415,38260,12668,24.87
2022-09-01,2022,Q3,66964,73514,38073,28891,43.14
2022-09-02,2022,Q3,63851,74150,33887,29964,46.93
2022-09-03,2022,Q3,29998,29793,35707,-5709,-19.03
2022-09-04,2022,Q3,35659,31619,37744,-2085,-5.85
2022-09-05,2022,Q3,53420,45717,37062,16358,30.62
2022-09-06,2022,Q3,59171,57397,34905,24266,41.01
2022-09-07,2022,Q3,47568,47265,36493,11075,23.28
2022-09-08,2022,Q3,50907,46822,34185,16722,32.85
2022-09-09,2022,Q3,68922,81591,32666,36256,52.6
2022-09-10,2022,Q3,40082,42412,39549,533,1.33
2022-09-11,2022,Q3,40239,46860,36516,3723,9.25
2022-09-12,2022,Q3,64908,63528,35830,29078,44.8
2022-09-13,2022,Q3,50427,52980,33815,16612,32.94
2022-09-14,2022,Q3,46168,38793,38207,7961,17.24
2022-09-15,2022,Q3,48390,50116,39675,8715,18.01
2022-09-16,2022,Q3,67614,71719,35929,31685,46.86
2022-09-17,2022,Q3,28348,31868,36768,-8420,-29.7
2022-09-18,2022,Q3,32954,34438,32724,230,0.7
2022-09-19,2022,Q3,60752,65256,36845,23907,39.35
2022-09-20,2022,Q3,67345,58362,34785,32560,48.35
2022-09-21,2022,Q3,56066,54577,36036,20030,35.73
2022-09-22,2022,Q3,54992,61817,39558,15434,28.07
2022-09-23,2022,Q3,67025,76652,35305,31720,47.33
2022-09-24,2022,Q3,35259,28463,36925,-1666,-4.73
2022-09-25,2022,Q3,31804,36373,35093,-3289,-10.34
2022-09-26,2022,Q3,57788,48556,38650,19138,33.12
2022-09-27,2022,Q3,64392,76046,39357,25035,38.88
2022-09-28,2022,Q3,58642,51406,33313,25329,43.19
2022-09-29,2022,Q3,53609,46346,33327,20282,37.83
2022-09-30,2022,Q3,53309,52864,34817,18492,34.69
2022-10-01,2022,Q4,32630,30016,32637,-7,-0.02
2022-10-02,2022,Q4,37809,38096,33575,4234,11.2
2022-10-03,2022,Q4,56645,52404,36599,20046,35.39
2022-10-04,2022,Q4,65361,72048,36504,28857,44.15
2022-10-05,2022,Q4,47758,37738,36277,11481,24.04
2022-10-06,2022,Q4,55318,59638,36598,18720,33.84
2022-10-07,2022,Q4,56858,62269,34220,22638,39.81
2022-10-08,2022,Q4,31615,31201,35477,-3862,-12.22
2022-10-09,2022,Q4,39302,44624,33804,5498,13.99
2022-10-10,2022,Q4,50120,60058,39613,10507,20.96
2022-10-11,2022,Q4,54252,48090,33057,21195,39.07
2022-10-12,2022,Q4,50755,58213,36005,14750,29.06
2022-10-13,2022,Q4,68553,65027,36379,32174,46.93
2022-10-14,2022,Q4,52056,51251,37338,14718,28.27
2022-10-15,2022,Q4,39129,38902,39175,-46,-0.12
2022-10-16,2022,Q4,39574,39295,36980,2594,6.55
2022-10-17,2022,Q4,49808,41975,34134,15674,31.47
2022-10-18,2022,Q4,62497,51527,38479,24018,38.43
2022-10-19,2022,Q4,57012,48706,38640,18372,32.22
2022-10-20,2022,Q4,59190,51829,32886,26304,44.44
2022-10-21,2022,Q4,51939,47367,36944,14995,28.87
2022-10-22,2022,Q4,37529,39091,33223,4306,11.47
2022-10-23,2022,Q4,39568,35488,36955,2613,6.6
2022-10-24,2022,Q4,50183,52130,37849,12334,24.58
2022-10-25,2022,Q4,59583,52534,33389,26194,43.96
2022-10-26,2022,Q4,57600,53798,33300,24300,42.19
2022-10-27,2022,Q4,46897,52239,33453,13444,28.67
2022-10-28,2022,Q4,59879,70412,38216,21663,36.18
2022-10-29,2022,Q4,32711,26816,34265,-1554,-4.75
2022-10-30,2022,Q4,32861,34852,38119,-5258,-16.0
2022-10-31,2022,Q4,49079,47329,38826,10253,20.89
2022-11-01,2022,Q4,72018,64378,38321,33697,46.79
2022-11-02,2022,Q4,60015,64921,34891,25124,41.86
2022-11-03,2022,Q4,79282,74005,35671,43611,55.01
2022-11-04,2022,Q4,80150,87557,38281,41869,52.24
2022-11-05,2022,Q4,45835,40521,35097,10738,23.43
2022-11-06,2022,Q4,51218,55831,35838,15380,30.03
2022-11-07,2022,Q4,66212,62551,36591,29621,44.74
2022-11-08,2022,Q4,64606,72821,33262,31344,48.52
2022-11-09,2022,Q4,72817,58447,33182,39635,54.43
2022-11-10,2022,Q4,89234,93497,37758,51476,57.69
2022-11-11,2022,Q4,84324,88512,34063,50261,59.6
2022-11-12,2022,Q4,41010,33691,36339,4671,11.39
2022-11-13,2022,Q4,36526,31081,33743,2783,7.62
2022-11-14,2022,Q4,70358,67987,36353,34005,48.33
2022-11-15,2022,Q4,62495,58990,39231,23264,37.23
2022-11-16,2022,Q4,68067,68795,39338,28729,42.21
2022-11-17,2022,Q4,71973,58050,34734,37239,51.74
2022-11-18,2022,Q4,88405,104889,36767,51638,58.41
2022-11-19,2022,Q4,45983,52260,39566,6417,13.96
2022-11-20,2022,Q4,46407,36189,33091,13316,28.69
2022-11-21,2022,Q4,149332,130745,39524,109808,73.53
2022-11-22,2022,Q4,67222,57256,38551,28671,42.65
2022-11-23,2022,Q4,74049,72459,34551,39498,53.34
2022-11-24,2022,Q4,87006,84359,37930,49076,56.41
2022-11-25,2022,Q4,65862,59970,33732,32130,48.78
2022-11-26,2022,Q4,48004,51724,38139,9865,20.55
2022-11-27,2022,Q4,44532,46645,39741,4791,10.76
2022-11-28,2022,Q4,74475,92603,34633,39842,53.5
2022-11-29,2022,Q4,61419,68622,36520,24899,40.54
2022-11-30,2022,Q4,80321,73202,37661,42660,53.11
2022-12-01,2022,Q4,60153,53624,34960,25193,41.88
2022-12-02,2022,Q4,76202,67994,37044,39158,51.39
2022-12-03,2022,Q4,39656,42292,38792,864,2.18
2022-12-04,2022,Q4,38232,38323,33326,4906,12.83
2022-12-05,2022,Q4,72723,66805,39551,33172,45.61
2022-12-06,2022,Q4,65080,68294,38756,26324,40.45
2022-12-07,2022,Q4,83281,77095,36716,46565,55.91
2022-12-08,2022,Q4,61595,69164,37165,24430,39.66
2022-12-09,2022,Q4,70592,75418,52414,18178,25.75
2022-12-10,2022,Q4,48071,50486,37310,10761,22.39
2022-12-11,2022,Q4,40985,38157,38215,2770,6.76
2022-12-12,2022,Q4,78148,80531,38893,39255,50.23
2022-12-13,2022,Q4,72412,74944,39174,33238,45.9
2022-12-14,2022,Q4,69173,74951,36988,32185,46.53
2022-12-15,2022,Q4,83151,100167,36376,46775,56.25
2022-12-16,2022,Q4,85340,70615,34425,50915,59.66
2022-12-17,2022,Q4,39657,36485,39389,268,0.68
2022-12-18,2022,Q4,49710,52676,33355,16355,32.9
2022-12-19,2022,Q4,87654,81524,37946,49708,56.71
2022-12-20,2022,Q4,75549,62545,35187,40362,53.42
2022-12-21,2022,Q4,73769,88397,36576,37193,50.42
2022-12-22,2022,Q4,75924,78340,38028,37896,49.91
2022-12-23,2022,Q4,78929,83266,36092,42837,54.27
2022-12-24,2022,Q4,41403,38573,32678,8725,21.07
2022-12-25,2022,Q4,38325,35179,37585,740,1.93
2022-12-26,2022,Q4,68758,78336,36927,31831,46.29
2022-12-27,2022,Q4,65438,74966,34412,31026,47.41
2022-12-28,2022,Q4,84569,71956,37132,47437,56.09
2022-12-29,2022,Q4,78135,82275,37300,40835,52.26
2022-12-30,2022,Q4,65421,52161,33402,32019,48.94
2022-12-31,2022,Q4,48446,47424,33704,14742,30.43
2023-01-01,2023,Q1,37094,32591,56356,-19262,-51.93
2023-01-02,2023,Q1,51866,47670,43402,8464,16.32
2023-01-03,2023,Q1,58061,55977,44648,13413,23.1
2023-01-04,2023,Q1,43084,41259,43747,-663,-1.54
2023-01-05,2023,Q1,44136,47643,43171,965,2.19
2023-01-06,2023,Q1,42297,42762,41123,1174,2.78
2023-01-07,2023,Q1,33464,30401,42007,-8543,-25.53
2023-01-08,2023,Q1,31461,28749,38482,-7021,-22.32
2023-01-09,2023,Q1,46129,39505,39512,6617,14.34
2023-01-10,2023,Q1,44088,46771,37198,6890,15.63
2023-01-11,2023,Q1,54001,49120,38146,15855,29.36
2023-01-12,2023,Q1,60961,73993,37344,23617,38.74
2023-01-13,2023,Q1,58062,48052,44894,13168,22.68
2023-01-14,2023,Q1,35012,33105,42499,-7487,-21.38
2023-01-15,2023,Q1,36175,35737,39268,-3093,-8.55
2023-01-16,2023,Q1,45481,43702,39109,6372,14.01
2023-01-17,2023,Q1,53134,42454,39276,13858,26.08
2023-01-18,2023,Q1,41614,43380,72234,-30620,-73.58
2023-01-19,2023,Q1,46566,51484,41269,5297,11.38
2023-01-20,2023,Q1,51949,53617,39497,12452,23.97
2023-01-21,2023,Q1,31489,26903,37917,-6428,-20.41
2023-01-22,2023,Q1,31017,26223,43704,-12687,-40.9
2023-01-23,2023,Q1,56187,50024,41817,14370,25.58
2023-01-24,2023,Q1,45941,47567,37509,8432,18.35
2023-01-25,2023,Q1,53206,62007,39877,13329,25.05
2023-01-26,2023,Q1,47128,36816,39343,7785,16.52
2023-01-27,2023,Q1,43620,47699,38406,5214,11.95
2023-01-28,2023,Q1,32764,29267,40255,-7491,-22.86
2023-01-29,2023,Q1,29427,29419,44085,-14658,-49.81
2023-01-30,2023,Q1,49952,45108,45032,4920,9.85
2023-01-31,2023,Q1,48155,56611,39899,8256,17.14
2023-02-01,2023,Q1,56698,59530,38607,18091,31.91
2023-02-02,2023,Q1,46885,55251,40107,6778,14.46
2023-02-03,2023,Q1,53991,57054,39327,14664,27.16
2023-02-04,2023,Q1,35639,29748,42503,-6864,-19.26
2023-02-05,2023,Q1,31902,36047,37164,-5262,-16.49
2023-02-06,2023,Q1,49235,49495,43497,5738,11.65
2023-02-07,2023,Q1,60691,67862,43348,17343,28.58
2023-02-08,2023,Q1,55943,59998,41729,14214,25.41
2023-02-09,2023,Q1,53586,42572,43168,10418,19.44
2023-02-10,2023,Q1,50263,59790,38711,11552,22.98
2023-02-11,2023,Q1,25102,27559,39351,-14249,-56.76
2023-02-12,2023,Q1,26826,26102,37268,-10442,-38.92
2023-02-13,2023,Q1,50868,52828,38673,12195,23.97
2023-02-14,2023,Q1,44349,37207,37258,7091,15.99
2023-02-15,2023,Q1,52037,55602,37959,14078,27.05
2023-02-16,2023,Q1,55166,49022,42880,12286,22.27
2023-02-17,2023,Q1,57756,55953,37588,20168,34.92
2023-02-18,2023,Q1,29306,27460,37053,-7747,-26.43
2023-02-19,2023,Q1,32650,38825,38049,-5399,-16.54
2023-02-20,2023,Q1,45753,44563,43839,1914,4.18
2023-02-21,2023,Q1,61337,74454,60863,474,0.77
2023-02-22,2023,Q1,51400,49094,38590,12810,24.92
2023-02-23,2023,Q1,53015,58362,42547,10468,19.75
2023-02-24,2023,Q1,60445,59598,37347,23098,38.21
2023-02-25,2023,Q1,28345,29191,37400,-9055,-31.95
2023-02-26,2023,Q1,36352,32973,39250,-2898,-7.97
2023-02-27,2023,Q1,61979,63494,44257,17722,28.59
2023-02-28,2023,Q1,43430,39981,41447,1983,4.57
2023-03-01,2023,Q1,75979,69979,76013,-34,-0.04
2023-03-02,2023,Q1,59860,75169,39114,20746,34.66
2023-03-03,2023,Q1,62066,78130,44587,17479,28.16
2023-03-04,2023,Q1,36531,33696,42832,-6301,-17.25
2023-03-05,2023,Q1,44814,47759,41547,3267,7.29
2023-03-06,2023,Q1,67739,63918,42198,25541,37.71
2023-03-07,2023,Q1,57260,49894,44214,13046,22.78
2023-03-08,2023,Q1,75634,85113,41481,34153,45.16
2023-03-09,2023,Q1,65857,69374,43730,22127,33.6
2023-03-10,2023,Q1,60285,74994,39339,20946,34.74
2023-03-11,2023,Q1,41134,43487,38394,2740,6.66
2023-03-12,2023,Q1,46580,49273,41870,4710,10.11
2023-03-13,2023,Q1,52678,45043,37953,14725,27.95
2023-03-14,2023,Q1,68888,59502,40735,28153,40.87
2023-03-15,2023,Q1,62623,77530,44637,17986,28.72
2023-03-16,2023,Q1,57273,48873,44673,12600,22.0
2023-03-17,2023,Q1,69884,83242,40356,29528,42.25
2023-03-18,2023,Q1,44059,47432,44546,-487,-1.11
2023-03-19,2023,Q1,41205,42512,37750,3455,8.38
2023-03-20,2023,Q1,74822,67466,44912,29910,39.97
2023-03-21,2023,Q1,71894,82554,40454,31440,43.73
2023-03-22,2023,Q1,59433,50445,44381,15052,25.33
2023-03-23,2023,Q1,64053,65019,40955,23098,36.06
2023-03-24,2023,Q1,75252,75829,39504,35748,47.5
2023-03-25,2023,Q1,45187,54343,37593,7594,16.81
2023-03-26,2023,Q1,42298,37467,37601,4697,11.1
2023-03-27,2023,Q1,54217,60044,44841,9376,17.29
2023-03-28,2023,Q1,66308,52426,39600,26708,40.28
2023-03-29,2023,Q1,56215,49521,37275,18940,33.69
2023-03-30,2023,Q1,139521,123654,44214,95307,68.31
2023-03-31,2023,Q1,52317,52260,43468,8849,16.91
2023-04-01,2023,Q2,65906,69784,40473,25433,38.59
2023-04-02,2023,Q2,35538,38562,38555,-3017,-8.49
2023-04-03,2023,Q2,61074,49960,41589,19485,31.9
2023-04-04,2023,Q2,54280,48048,38176,16104,29.67
2023-04-05,2023,Q2,70196,72674,44768,25428,36.22
2023-04-06,2023,Q2,52931,57577,44205,8726,16.49
2023-04-07,2023,Q2,73926,60882,37854,36072,48.79
2023-04-08,2023,Q2,37654,32315,37331,323,0.86
2023-04-09,2023,Q2,39451,33682,41808,-2357,-5.97
2023-04-10,2023,Q2,63103,70154,41565,21538,34.13
2023-04-11,2023,Q2,67971,69428,40931,27040,39.78
2023-04-12,2023,Q2,58050,51555,37823,20227,34.84
2023-04-13,2023,Q2,71174,63566,40250,30924,43.45
2023-04-14,2023,Q2,72957,65470,42506,30451,41.74
2023-04-15,2023,Q2,35884,37578,37787,-1903,-5.3
2023-04-16,2023,Q2,40075,49026,38443,1632,4.07
2023-04-17,2023,Q2,64456,60835,37966,26490,41.1
2023-04-18,2023,Q2,74495,85969,43523,30972,41.58
2023-04-19,2023,Q2,65547,68448,89241,-23694,-36.15
2023-04-20,2023,Q2,72787,82853,44796,27991,38.46
2023-04-21,2023,Q2,77574,84290,41531,36043,46.46
2023-04-22,2023,Q2,44687,50192,39430,5257,11.76
2023-04-23,2023,Q2,38954,34698,44641,-5687,-14.6
2023-04-24,2023,Q2,54918,62876,44335,10583,19.27
2023-04-25,2023,Q2,64549,62550,44419,20130,31.19
2023-04-26,2023,Q2,72163,64166,43588,28575,39.6
2023-04-27,2023,Q2,107898,117112,42700,65198,60.43
2023-04-28,2023,Q2,69863,69504,40678,29185,41.77
2023-04-29,2023,Q2,41480,38666,39411,2069,4.99
2023-04-30,2023,Q2,34203,30583,40467,-6264,-18.31
2023-05-01,2023,Q2,59114,48237,41065,18049,30.53
2023-05-02,2023,Q2,60280,52692,39174,21106,35.01
2023-05-03,2023,Q2,67944,63203,37920,30024,44.19
2023-05-04,2023,Q2,54754,44650,38320,16434,30.01
2023-05-05,2023,Q2,73740,80546,39413,34327,46.55
2023-05-06,2023,Q2,41665,44223,43044,-1379,-3.31
2023-05-07,2023,Q2,43880,51083,40586,3294,7.51
2023-05-08,2023,Q2,64100,55640,43907,20193,31.5
2023-05-09,2023,Q2,62193,68268,43315,18878,30.35
2023-05-10,2023,Q2,52786,51488,40632,12154,23.03
2023-05-11,2023,Q2,67715,55334,43550,24165,35.69
2023-05-12,2023,Q2,68885,77194,40137,28748,41.73
2023-05-13,2023,Q2,39748,46733,39645,103,0.26
2023-05-14,2023,Q2,43435,43527,41314,2121,4.88
2023-05-15,2023,Q2,54025,63805,40840,13185,24.41
2023-05-16,2023,Q2,66432,72560,44683,21749,32.74
2023-05-17,2023,Q2,73165,80124,40903,32262,44.09
2023-05-18,2023,Q2,73242,87998,61679,11563,15.79
2023-05-19,2023,Q2,63777,59133,40517,23260,36.47
2023-05-20,2023,Q2,35875,40818,44377,-8502,-23.7
2023-05-21,2023,Q2,45475,54843,41863,3612,7.94
2023-05-22,2023,Q2,74165,63637,91484,-17319,-23.35
2023-05-23,2023,Q2,61340,72770,38781,22559,36.78
2023-05-24,2023,Q2,60271,56764,41319,18952,31.44
2023-05-25,2023,Q2,56893,56570,43734,13159,23.13
2023-05-26,2023,Q2,69421,56727,36983,32438,46.73
2023-05-27,2023,Q2,38013,43578,42114,-4101,-10.79
2023-05-28,2023,Q2,43507,44987,38327,5180,11.91
2023-05-29,2023,Q2,63701,58128,41806,21895,34.37
2023-05-30,2023,Q2,58155,57676,41328,16827,28.93
2023-05-31,2023,Q2,66771,69448,40798,25973,38.9
2023-06-01,2023,Q2,78114,97732,43233,34881,44.65
2023-06-02,2023,Q2,82651,68854,42929,39722,48.06
2023-06-03,2023,Q2,45194,49634,37287,7907,17.5
2023-06-04,2023,Q2,42365,42448,42864,-499,-1.18
2023-06-05,2023,Q2,80029,69876,44413,35616,44.5
2023-06-06,2023,Q2,73321,60295,38239,35082,47.85
2023-06-07,2023,Q2,80334,82530,37530,42804,53.28
2023-06-08,2023,Q2,65146,54353,61190,3956,6.07
2023-06-09,2023,Q2,83229,92635,39883,43346,52.08
2023-06-10,2023,Q2,38373,33565,37126,1247,3.25
2023-06-11,2023,Q2,44539,51967,43020,1519,3.41
2023-06-12,2023,Q2,76095,80213,41586,34509,45.35
2023-06-13,2023,Q2,64761,69769,40655,24106,37.22
2023-06-14,2023,Q2,84320,95943,42452,41868,49.65
2023-06-15,2023,Q2,72370,68992,43384,28986,40.05
2023-06-16,2023,Q2,72365,82115,41206,31159,43.06
2023-06-17,2023,Q2,44795,46439,39068,5727,12.78
2023-06-18,2023,Q2,44344,44419,38835,5509,12.42
2023-06-19,2023,Q2,72070,81000,49975,22095,30.66
2023-06-20,2023,Q2,57542,46369,40507,17035,29.6
2023-06-21,2023,Q2,62722,48700,44541,18181,28.99
2023-06-22,2023,Q2,84383,90896,37837,46546,55.16
2023-06-23,2023,Q2,75972,88706,44776,31196,41.06
2023-06-24,2023,Q2,38667,39820,42086,-3419,-8.84
2023-06-25,2023,Q2,41647,49672,39503,2144,5.15
2023-06-26,2023,Q2,79425,74434,37346,42079,52.98
2023-06-27,2023,Q2,69800,72550,41853,27947,40.04
2023-06-28,2023,Q2,61314,65991,42123,19191,31.3
2023-06-29,2023,Q2,60154,50233,38907,21247,35.32
2023-06-30,2023,Q2,61457,67716,42298,19159,31.17
2023-07-01,2023,Q3,49843,51410,44552,5291,10.62
2023-07-02,2023,Q3,48803,55836,82870,-34067,-69.81
2023-07-03,2023,Q3,72509,85322,39335,33174,45.75
2023-07-04,2023,Q3,75706,74159,39640,36066,47.64
2023-07-05,2023,Q3,65492,58029,44778,20714,31.63
2023-07-06,2023,Q3,68356,58691,40839,27517,40.26
2023-07-07,2023,Q3,62618,48568,45015,17603,28.11
2023-07-08,2023,Q3,47923,50670,44757,3166,6.61
2023-07-09,2023,Q3,34601,31851,42760,-8159,-23.58
2023-07-10,2023,Q3,75900,79973,43981,31919,42.05
2023-07-11,2023,Q3,63863,54176,53860,10003,15.66
2023-07-12,2023,Q3,75755,61849,44264,31491,41.57
2023-07-13,2023,Q3,74681,81005,43550,31131,41.69
2023-07-14,2023,Q3,74806,59897,39617,35189,47.04
2023-07-15,2023,Q3,41218,35609,41325,-107,-0.26
2023-07-16,2023,Q3,37979,30060,37372,607,1.6
2023-07-17,2023,Q3,62006,56810,38850,23156,37.34
2023-07-18,2023,Q3,79824,83003,38147,41677,52.21
2023-07-19,2023,Q3,57406,68580,41717,15689,27.33
2023-07-20,2023,Q3,79858,76140,38026,41832,52.38
2023-07-21,2023,Q3,64042,56772,41738,22304,34.83
2023-07-22,2023,Q3,35830,39703,40284,-4454,-12.43
2023-07-23,2023,Q3,51250,61749,43920,7330,14.3
2023-07-24,2023,Q3,70476,71879,37289,33187,47.09
2023-07-25,2023,Q3,81332,94695,38163,43169,53.08
2023-07-26,2023,Q3,67615,58274,41906,25709,38.02
2023-07-27,2023,Q3,60186,49596,38149,22037,36.61
2023-07-28,2023,Q3,59226,52662,41603,17623,29.76
2023-07-29,2023,Q3,49736,42636,38720,11016,22.15
2023-07-30,2023,Q3,37751,41798,41646,-3895,-10.32
2023-07-31,2023,Q3,63382,64026,39913,23469,37.03
2023-08-01,2023,Q3,67455,60235,37117,30338,44.98
2023-08-02,2023,Q3,60377,59057,43082,17295,28.65
2023-08-03,2023,Q3,61684,72073,44271,17413,28.23
2023-08-04,2023,Q3,63769,61650,43916,19853,31.13
2023-08-05,2023,Q3,42261,33809,44001,-1740,-4.12
2023-08-06,2023,Q3,38136,46649,44338,-6202,-16.26
2023-08-07,2023,Q3,58464,71585,40984,17480,29.9
2023-08-08,2023,Q3,80357,83193,40911,39446,49.09
2023-08-09,2023,Q3,77024,72056,39790,37234,48.34
2023-08-10,2023,Q3,57655,59471,40616,17039,29.55
2023-08-11,2023,Q3,85125,80859,42613,42512,49.94
2023-08-12,2023,Q3,45076,46321,41992,3084,6.84
2023-08-13,2023,Q3,43430,40905,42572,858,1.98
2023-08-14,2023,Q3,63124,68603,39604,23520,37.26
2023-08-15,2023,Q3,83226,75169,39991,43235,51.95
2023-08-16,2023,Q3,67679,73159,41447,26232,38.76
2023-08-17,2023,Q3,66778,68847,42894,23884,35.77
2023-08-18,2023,Q3,77301,87350,39479,37822,48.93
2023-08-19,2023,Q3,41577,33732,40560,1017,2.45
2023-08-20,2023,Q3,42388,44325,44221,-1833,-4.32
2023-08-21,2023,Q3,76456,86302,44087,32369,42.34
2023-08-22,2023,Q3,59697,55253,44703,14994,25.12
2023-08-23,2023,Q3,60403,50083,38527,21876,36.22
2023-08-24,2023,Q3,69112,77355,40736,28376,41.06
2023-08-25,2023,Q3,57814,48203,43423,14391,24.89
2023-08-26,2023,Q3,40083,41988,43299,-3216,-8.02
2023-08-27,2023,Q3,43417,44072,41500,1917,4.42
2023-08-28,2023,Q3,79773,70144,39214,40559,50.84
2023-08-29,2023,Q3,65333,78171,38171,27162,41.57
2023-08-30,2023,Q3,62215,70121,43361,18854,30.3
2023-08-31,2023,Q3,85621,87652,39882,45739,53.42
2023-09-01,2023,Q3,69304,79649,40527,28777,41.52
2023-09-02,2023,Q3,33095,27961,43149,-10054,-30.38
2023-09-03,2023,Q3,33634,40143,41010,-7376,-21.93
2023-09-04,2023,Q3,75295,91711,44996,30299,40.24
2023-09-05,2023,Q3,70942,81587,37774,33168,46.75
2023-09-06,2023,Q3,69628,56155,41912,27716,39.81
2023-09-07,2023,Q3,60485,61177,41166,19319,31.94
2023-09-08,2023,Q3,57088,49241,42400,14688,25.73
2023-09-09,2023,Q3,37353,37594,41044,-3691,-9.88
2023-09-10,2023,Q3,37401,40337,72621,-35220,-94.17
2023-09-11,2023,Q3,77415,85335,42816,34599,44.69
2023-09-12,2023,Q3,72895,68771,44802,28093,38.54
2023-09-13,2023,Q3,55628,55185,38556,17072,30.69
2023-09-14,2023,Q3,77652,67127,43047,34605,44.56
2023-09-15,2023,Q3,75774,73591,42671,33103,43.69
2023-09-16,2023,Q3,34101,32663,37200,-3099,-9.09
2023-09-17,2023,Q3,35941,36658,64288,-28347,-78.87
2023-09-18,2023,Q3,68654,69683,42308,26346,38.38
2023-09-19,2023,Q3,75576,76182,43118,32458,42.95
2023-09-20,2023,Q3,67571,63710,40426,27145,40.17
2023-09-21,2023,Q3,77330,86069,69866,7464,9.65
2023-09-22,2023,Q3,53521,51539,37964,15557,29.07
2023-09-23,2023,Q3,37744,43332,39228,-1484,-3.93
2023-09-24,2023,Q3,39216,42020,37629,1587,4.05
2023-09-25,2023,Q3,74683,86008,39320,35363,47.35
2023-09-26,2023,Q3,54491,58053,36960,17531,32.17
2023-09-27,2023,Q3,64607,62964,37693,26914,41.66
2023-09-28,2023,Q3,56898,66682,43664,13234,23.26
2023-09-29,2023,Q3,66328,70305,40626,25702,38.75
2023-09-30,2023,Q3,45605,44379,39824,5781,12.68
2023-10-01,2023,Q4,40523,44088,42669,-2146,-5.3
2023-10-02,2023,Q4,57781,63666,38710,19071,33.01
2023-10-03,2023,Q4,54043,59820,37491,16552,30.63
2023-10-04,2023,Q4,53105,46086,41060,12045,22.68
2023-10-05,2023,Q4,58578,49226,43034,15544,26.54
2023-10-06,2023,Q4,57340,64443,39734,17606,30.7
2023-10-07,2023,Q4,45892,53306,38169,7723,16.83
2023-10-08,2023,Q4,34972,34513,65810,-30838,-88.18
2023-10-09,2023,Q4,77070,68652,36890,40180,52.13
2023-10-10,2023,Q4,75932,86382,42572,33360,43.93
2023-10-11,2023,Q4,54790,65116,40328,14462,26.4
2023-10-12,2023,Q4,71796,66235,41111,30685,42.74
2023-10-13,2023,Q4,59495,62075,40898,18597,31.26
2023-10-14,2023,Q4,42684,47442,38704,3980,9.32
2023-10-15,2023,Q4,37876,44989,43426,-5550,-14.65
2023-10-16,2023,Q4,52332,56940,40101,12231,23.37
2023-10-17,2023,Q4,55099,53810,44861,10238,18.58
2023-10-18,2023,Q4,56386,51707,38495,17891,31.73
2023-10-19,2023,Q4,58054,56300,43118,14936,25.73
2023-10-20,2023,Q4,71663,83849,39771,31892,44.5
2023-10-21,2023,Q4,46605,45166,40578,6027,12.93
2023-10-22,2023,Q4,34800,39032,42897,-8097,-23.27
2023-10-23,2023,Q4,52695,46411,39532,13163,24.98
2023-10-24,2023,Q4,71764,76540,40886,30878,43.03
2023-10-25,2023,Q4,64945,65345,43484,21461,33.04
2023-10-26,2023,Q4,71863,89236,37830,34033,47.36
2023-10-27,2023,Q4,63506,50047,42255,21251,33.46
2023-10-28,2023,Q4,33760,32208,40041,-6281,-18.6
2023-10-29,2023,Q4,38852,39844,40702,-1850,-4.76
2023-10-30,2023,Q4,53449,48830,39949,13500,25.26
2023-10-31,2023,Q4,59395,49418,37904,21491,36.18
2023-11-01,2023,Q4,87338,97811,39971,47367,54.23
2023-11-02,2023,Q4,81523,65343,38776,42747,52.44
2023-11-03,2023,Q4,90854,100242,38245,52609,57.9
2023-11-04,2023,Q4,53899,52304,40304,13595,25.22
2023-11-05,2023,Q4,41010,38267,39495,1515,3.69
2023-11-06,2023,Q4,90951,80225,43500,47451,52.17
2023-11-07,2023,Q4,77723,89563,42059,35664,45.89
2023-11-08,2023,Q4,96341,83318,39290,57051,59.22
2023-11-09,2023,Q4,88710,107244,41590,47120,53.12
2023-11-10,2023,Q4,86745,87182,39699,47046,54.23
2023-11-11,2023,Q4,50794,47492,39421,11373,22.39
2023-11-12,2023,Q4,51011,54770,44069,6942,13.61
2023-11-13,2023,Q4,73905,75069,43602,30303,41.0
2023-11-14,2023,Q4,89161,103712,44281,44880,50.34
2023-11-15,2023,Q4,69624,61057,38823,30801,44.24
2023-11-16,2023,Q4,96131,96018,44317,51814,53.9
2023-11-17,2023,Q4,76622,67716,42480,34142,44.56
2023-11-18,2023,Q4,43601,36414,39398,4203,9.64
2023-11-19,2023,Q4,49118,55386,39088,10030,20.42
2023-11-20,2023,Q4,76988,79682,37200,39788,51.68
2023-11-21,2023,Q4,69470,78990,39295,30175,43.44
2023-11-22,2023,Q4,97910,108669,40105,57805,59.04
2023-11-23,2023,Q4,75578,77725,37843,37735,49.93
2023-11-24,2023,Q4,93798,94712,37594,56204,59.92
2023-11-25,2023,Q4,46915,54412,43454,3461,7.38
2023-11-26,2023,Q4,44981,36822,39103,5878,13.07
2023-11-27,2023,Q4,69490,71826,37780,31710,45.63
2023-11-28,2023,Q4,75926,71142,38041,37885,49.9
2023-11-29,2023,Q4,78016,85898,37140,40876,52.39
2023-11-30,2023,Q4,69447,82434,38926,30521,43.95
2023-12-01,2023,Q4,91280,107963,41235,50045,54.83
2023-12-02,2023,Q4,40719,50285,44372,-3653,-8.97
2023-12-03,2023,Q4,55905,53221,38167,17738,31.73
2023-12-04,2023,Q4,95053,103453,39099,55954,58.87
2023-12-05,2023,Q4,84219,96133,39579,44640,53.0
2023-12-06,2023,Q4,70993,59881,37398,33595,47.32
2023-12-07,2023,Q4,86113,81710,43095,43018,49.96
2023-12-08,2023,Q4,82587,82912,38493,44094,53.39
2023-12-09,2023,Q4,42807,39342,43141,-334,-0.78
2023-12-10,2023,Q4,52606,52947,40552,12054,22.91
2023-12-11,2023,Q4,73463,74882,39162,34301,46.69
2023-12-12,2023,Q4,80900,79504,41526,39374,48.67
2023-12-13,2023,Q4,86478,87901,37583,48895,56.54
2023-12-14,2023,Q4,96391,79964,41772,54619,56.66
2023-12-15,2023,Q4,73350,71663,41161,32189,43.88
2023-12-16,2023,Q4,57336,55625,38518,18818,32.82
2023-12-17,2023,Q4,45958,49893,40387,5571,12.12
2023-12-18,2023,Q4,95454,100876,38332,57122,59.84
2023-12-19,2023,Q4,100593,89508,38888,61705,61.34
2023-12-20,2023,Q4,70497,72205,44835,25662,36.4
2023-12-21,2023,Q4,80562,78849,37453,43109,53.51
2023-12-22,2023,Q4,99069,96490,41821,57248,57.79
2023-12-23,2023,Q4,54949,58704,40987,13962,25.41
2023-12-24,2023,Q4,54173,48016,37191,16982,31.35
2023-12-25,2023,Q4,84257,78585,37589,46668,55.39
2023-12-26,2023,Q4,76401,74077,40943,35458,46.41
2023-12-27,2023,Q4,79788,80680,39010,40778,51.11
2023-12-28,2023,Q4,85073,80110,42889,42184,49.59
2023-12-29,2023,Q4,86381,102371,40458,45923,53.16
2023-12-30,2023,Q4,44274,42275,40680,3594,8.12
2023-12-31,2023,Q4,50596,51827,41448,9148,18.08
2024-01-01,2024,Q1,63098,53399,42968,20130,31.9
2024-01-02,2024,Q1,63798,72485,47165,16633,26.07
2024-01-03,2024,Q1,46495,49814,49515,-3020,-6.5
2024-01-04,2024,Q1,48587,44280,50071,-1484,-3.05
2024-01-05,2024,Q1,67956,56237,41371,26585,39.12
2024-01-06,2024,Q1,34519,35454,47118,-12599,-36.5
2024-01-07,2024,Q1,36503,37420,50240,-13737,-37.63
2024-01-08,2024,Q1,49400,58284,43692,5708,11.55
2024-01-09,2024,Q1,59094,59005,43438,15656,26.49
2024-01-10,2024,Q1,55654,43667,44656,10998,19.76
2024-01-11,2024,Q1,68542,57869,48425,20117,29.35
2024-01-12,2024,Q1,67366,69166,41985,25381,37.68
2024-01-13,2024,Q1,34040,31763,46591,-12551,-36.87
2024-01-14,2024,Q1,32965,29206,41956,-8991,-27.27
2024-01-15,2024,Q1,62093,67164,49609,12484,20.11
2024-01-16,2024,Q1,48348,45724,48429,-81,-0.17
2024-01-17,2024,Q1,62276,55863,45014,17262,27.72
2024-01-18,2024,Q1,67681,68116,44880,22801,33.69
2024-01-19,2024,Q1,65257,62010,88464,-23207,-35.56
2024-01-20,2024,Q1,30376,27863,49116,-18740,-61.69
2024-01-21,2024,Q1,34173,36952,43528,-9355,-27.38
2024-01-22,2024,Q1,50742,45445,46625,4117,8.11
2024-01-23,2024,Q1,58797,45366,42676,16121,27.42
2024-01-24,2024,Q1,66555,79760,45553,21002,31.56
2024-01-25,2024,Q1,54768,59690,44715,10053,18.36
2024-01-26,2024,Q1,46721,37557,49973,-3252,-6.96
2024-01-27,2024,Q1,36868,38825,46826,-9958,-27.01
2024-01-28,2024,Q1,32028,31477,41306,-9278,-28.97
2024-01-29,2024,Q1,62700,74121,48961,13739,21.91
2024-01-30,2024,Q1,59610,64535,41179,18431,30.92
2024-01-31,2024,Q1,69124,80630,46550,22574,32.66
2024-02-01,2024,Q1,57709,57910,46693,11016,19.09
2024-02-02,2024,Q1,57719,62843,44962,12757,22.1
2024-02-03,2024,Q1,40268,38829,45627,-5359,-13.31
2024-02-04,2024,Q1,37549,29708,42863,-5314,-14.15
2024-02-05,2024,Q1,51497,58959,46607,4890,9.5
2024-02-06,2024,Q1,49442,46314,49875,-433,-0.88
2024-02-07,2024,Q1,63442,73079,48822,14620,23.04
2024-02-08,2024,Q1,63782,65520,42929,20853,32.69
2024-02-09,2024,Q1,56050,65802,43020,13030,23.25
2024-02-10,2024,Q1,40102,36518,48670,-8568,-21.37
2024-02-11,2024,Q1,28726,28257,42209,-13483,-46.94
2024-02-12,2024,Q1,54295,48832,49125,5170,9.52
2024-02-13,2024,Q1,62411,63859,47560,14851,23.8
2024-02-14,2024,Q1,57005,62273,42074,14931,26.19
2024-02-15,2024,Q1,68379,73692,42070,26309,38.48
2024-02-16,2024,Q1,67534,57057,45140,22394,33.16
2024-02-17,2024,Q1,29222,30429,42366,-13144,-44.98
2024-02-18,2024,Q1,33627,36297,48499,-14872,-44.23
2024-02-19,2024,Q1,48377,47078,44401,3976,8.22
2024-02-20,2024,Q1,63881,60198,48431,15450,24.19
2024-02-21,2024,Q1,57043,67000,44412,12631,22.14
2024-02-22,2024,Q1,46630,54664,41881,4749,10.18
2024-02-23,2024,Q1,50212,42477,47138,3074,6.12
2024-02-24,2024,Q1,28644,30795,47139,-18495,-64.57
2024-02-25,2024,Q1,33435,36046,43887,-10452,-31.26
2024-02-26,2024,Q1,46583,42597,49515,-2932,-6.29
2024-02-27,2024,Q1,51159,53569,47063,4096,8.01
2024-02-28,2024,Q1,64532,60188,43861,20671,32.03
2024-02-29,2024,Q1,63222,66701,50168,13054,20.65
2024-03-01,2024,Q1,74001,76550,42569,31432,42.48
2024-03-02,2024,Q1,45109,41550,47744,-2635,-5.84
2024-03-03,2024,Q1,35843,34453,44345,-8502,-23.72
2024-03-04,2024,Q1,61617,57978,45246,16371,26.57
2024-03-05,2024,Q1,86681,92463,46841,39840,45.96
2024-03-06,2024,Q1,68159,64058,47637,20522,30.11
2024-03-07,2024,Q1,73070,64562,46427,26643,36.46
2024-03-08,2024,Q1,60841,68158,41856,18985,31.2
2024-03-09,2024,Q1,43086,41607,45914,-2828,-6.56
2024-03-10,2024,Q1,41669,37725,44975,-3306,-7.93
2024-03-11,2024,Q1,72196,88643,42426,29770,41.23
2024-03-12,2024,Q1,61752,69230,42185,19567,31.69
2024-03-13,2024,Q1,79648,92570,49802,29846,37.47
2024-03-14,2024,Q1,61505,60361,42507,18998,30.89
2024-03-15,2024,Q1,66794,68352,42405,24389,36.51
2024-03-16,2024,Q1,50360,56541,48590,1770,3.51
2024-03-17,2024,Q1,40866,46534,46342,-5476,-13.4
2024-03-18,2024,Q1,80659,81616,46640,34019,42.18
2024-03-19,2024,Q1,71367,69581,49021,22346,31.31
2024-03-20,2024,Q1,77270,72486,44719,32551,42.13
2024-03-21,2024,Q1,83811,93058,49017,34794,41.51
2024-03-22,2024,Q1,81088,88351,42238,38850,47.91
2024-03-23,2024,Q1,45565,44865,46316,-751,-1.65
2024-03-24,2024,Q1,50405,44613,66236,-15831,-31.41
2024-03-25,2024,Q1,78462,90123,48478,29984,38.21
2024-03-26,2024,Q1,59304,64654,45099,14205,23.95
2024-03-27,2024,Q1,67204,58338,42014,25190,37.48
2024-03-28,2024,Q1,65411,53617,44827,20584,31.47
2024-03-29,2024,Q1,67433,52265,44669,22764,33.76
2024-03-30,2024,Q1,40441,39686,42212,-1771,-4.38
2024-03-31,2024,Q1,44996,46002,44624,372,0.83
2024-04-01,2024,Q2,71479,68713,44829,26650,37.28
2024-04-02,2024,Q2,65805,79370,43357,22448,34.11
2024-04-03,2024,Q2,66833,61662,46915,19918,29.8
2024-04-04,2024,Q2,68825,84503,46017,22808,33.14
2024-04-05,2024,Q2,71100,56707,48683,22417,31.53
2024-04-06,2024,Q2,34809,40772,46569,-11760,-33.78
2024-04-07,2024,Q2,40914,43444,45769,-4855,-11.87
2024-04-08,2024,Q2,74329,67685,42230,32099,43.19
2024-04-09,2024,Q2,66104,65015,49853,16251,24.58
2024-04-10,2024,Q2,67936,63003,45243,22693,33.4
2024-04-11,2024,Q2,67907,67479,41252,26655,39.25
2024-04-12,2024,Q2,58059,59822,47252,10807,18.61
2024-04-13,2024,Q2,47037,52173,48299,-1262,-2.68
2024-04-14,2024,Q2,35338,40719,47248,-11910,-33.7
2024-04-15,2024,Q2,128746,117510,48122,80624,62.62
2024-04-16,2024,Q2,85151,80944,41288,43863,51.51
2024-04-17,2024,Q2,68376,57809,43877,24499,35.83
2024-04-18,2024,Q2,72320,66858,49370,22950,31.73
2024-04-19,2024,Q2,63686,71119,49054,14632,22.98
2024-04-20,2024,Q2,44401,47550,47341,-2940,-6.62
2024-04-21,2024,Q2,37031,29853,46313,-9282,-25.07
2024-04-22,2024,Q2,80685,71998,50168,30517,37.82
2024-04-23,2024,Q2,65334,66596,49675,15659,23.97
2024-04-24,2024,Q2,59504,69475,50197,9307,15.64
2024-04-25,2024,Q2,71531,69317,49181,22350,31.25
2024-04-26,2024,Q2,70181,65343,42885,27296,38.89
2024-04-27,2024,Q2,35241,40432,44979,-9738,-27.63
2024-04-28,2024,Q2,37661,35249,41991,-4330,-11.5
2024-04-29,2024,Q2,75183,77672,43394,31789,42.28
2024-04-30,2024,Q2,67883,54856,48361,19522,28.76
2024-05-01,2024,Q2,75967,85044,46396,29571,38.93
2024-05-02,2024,Q2,58966,56459,41701,17265,29.28
2024-05-03,2024,Q2,70815,66014,41708,29107,41.1
2024-05-04,2024,Q2,39931,36500,47976,-8045,-20.15
2024-05-05,2024,Q2,46279,36787,48371,-2092,-4.52
2024-05-06,2024,Q2,67848,81979,45255,22593,33.3
2024-05-07,2024,Q2,60977,60561,48318,12659,20.76
2024-05-08,2024,Q2,76483,68481,47726,28757,37.6
2024-05-09,2024,Q2,81113,65593,45088,36025,44.41
2024-05-10,2024,Q2,67024,79482,42454,24570,36.66
2024-05-11,2024,Q2,41217,33393,47303,-6086,-14.77
2024-05-12,2024,Q2,49332,55970,42892,6440,13.05
2024-05-13,2024,Q2,80772,76922,47454,33318,41.25
2024-05-14,2024,Q2,67603,72951,46735,20868,30.87
2024-05-15,2024,Q2,71174,75771,67727,3447,4.84
2024-05-16,2024,Q2,71529,63199,48126,23403,32.72
2024-05-17,2024,Q2,68901,68310,74622,-5721,-8.3
2024-05-18,2024,Q2,36804,32690,46457,-9653,-26.23
2024-05-19,2024,Q2,35316,30035,49195,-13879,-39.3
2024-05-20,2024,Q2,74080,61465,48807,25273,34.12
2024-05-21,2024,Q2,77646,76009,42121,35525,45.75
2024-05-22,2024,Q2,64964,74180,49705,15259,23.49
2024-05-23,2024,Q2,83568,92034,42426,41142,49.23
2024-05-24,2024,Q2,63558,59701,46584,16974,26.71
2024-05-25,2024,Q2,35603,36097,45999,-10396,-29.2
2024-05-26,2024,Q2,35726,41439,48885,-13159,-36.83
2024-05-27,2024,Q2,64067,53183,47168,16899,26.38
2024-05-28,2024,Q2,79787,84494,45662,34125,42.77
2024-05-29,2024,Q2,68842,75798,45627,23215,33.72
2024-05-30,2024,Q2,84714,83502,43112,41602,49.11
2024-05-31,2024,Q2,69481,66580,46326,23155,33.33
2024-06-01,2024,Q2,48817,39943,45168,3649,7.47
2024-06-02,2024,Q2,47184,49104,45378,1806,3.83
2024-06-03,2024,Q2,73912,68177,43243,30669,41.49
2024-06-04,2024,Q2,66429,75629,46987,19442,29.27
2024-06-05,2024,Q2,66939,52900,42937,24002,35.86
2024-06-06,2024,Q2,73456,84246,43614,29842,40.63
2024-06-07,2024,Q2,95649,107830,79068,16581,17.34
2024-06-08,2024,Q2,44914,56240,48615,-3701,-8.24
2024-06-09,2024,Q2,50799,63483,49013,1786,3.52
2024-06-10,2024,Q2,70495,63534,46155,24340,34.53
2024-06-11,2024,Q2,74667,64452,45024,29643,39.7
2024-06-12,2024,Q2,77793,84604,42376,35417,45.53
2024-06-13,2024,Q2,87335,88715,44347,42988,49.22
2024-06-14,2024,Q2,87808,98888,43844,43964,50.07
2024-06-15,2024,Q2,38896,34869,50190,-11294,-29.04
2024-06-16,2024,Q2,55769,56790,44590,11179,20.05
2024-06-17,2024,Q2,76127,74069,49894,26233,34.46
2024-06-18,2024,Q2,69268,71724,48657,20611,29.76
2024-06-19,2024,Q2,70148,80757,42988,27160,38.72
2024-06-20,2024,Q2,78303,70561,44092,34211,43.69
2024-06-21,2024,Q2,95368,80557,47896,47472,49.78
2024-06-22,2024,Q2,42232,47567,48578,-6346,-15.03
2024-06-23,2024,Q2,49287,44194,47655,1632,3.31
2024-06-24,2024,Q2,95415,96373,46632,48783,51.13
2024-06-25,2024,Q2,81958,81356,41464,40494,49.41
2024-06-26,2024,Q2,93112,90400,48345,44767,48.08
2024-06-27,2024,Q2,90910,85007,46750,44160,48.58
2024-06-28,2024,Q2,84824,87856,47489,37335,44.01
2024-06-29,2024,Q2,41302,47801,47197,-5895,-14.27
2024-06-30,2024,Q2,55548,64056,48067,7481,13.47
2024-07-01,2024,Q3,87897,90512,44853,43044,48.97
2024-07-02,2024,Q3,65223,53609,47279,17944,27.51
2024-07-03,2024,Q3,76539,64077,43396,33143,43.3
2024-07-04,2024,Q3,85182,83639,41861,43321,50.86
2024-07-05,2024,Q3,77763,75156,42581,35182,45.24
2024-07-06,2024,Q3,41672,36261,42646,-974,-2.34
2024-07-07,2024,Q3,43510,41109,47633,-4123,-9.48
2024-07-08,2024,Q3,77901,64668,45883,32018,41.1
2024-07-09,2024,Q3,67079,71781,46572,20507,30.57
2024-07-10,2024,Q3,70235,65786,54765,15470,22.03
2024-07-11,2024,Q3,74554,66477,43122,31432,42.16
2024-07-12,2024,Q3,90291,75689,44904,45387,50.27
2024-07-13,2024,Q3,49037,41689,46055,2982,6.08
2024-07-14,2024,Q3,42371,38636,44781,-2410,-5.69
2024-07-15,2024,Q3,78434,66860,47044,31390,40.02
2024-07-16,2024,Q3,70772,65797,50088,20684,29.23
2024-07-17,2024,Q3,95397,105196,49868,45529,47.73
2024-07-18,2024,Q3,86012,96484,47444,38568,44.84
2024-07-19,2024,Q3,91998,88298,45511,46487,50.53
2024-07-20,2024,Q3,49477,47811,43230,6247,12.63
2024-07-21,2024,Q3,42732,46495,43928,-1196,-2.8
2024-07-22,2024,Q3,83570,67995,43817,39753,47.57
2024-07-23,2024,Q3,65009,76764,49748,15261,23.48
2024-07-24,2024,Q3,72672,78848,45865,26807,36.89
2024-07-25,2024,Q3,73001,61142,44133,28868,39.54
2024-07-26,2024,Q3,92721,96353,47386,45335,48.89
2024-07-27,2024,Q3,45581,42085,41162,4419,9.69
2024-07-28,2024,Q3,41963,42633,42973,-1010,-2.41
2024-07-29,2024,Q3,90315,103121,41821,48494,53.69
2024-07-30,2024,Q3,86821,75440,43381,43440,50.03
2024-07-31,2024,Q3,84075,78551,41838,42237,50.24
2024-08-01,2024,Q3,69151,67565,47821,21330,30.85
2024-08-02,2024,Q3,89114,71143,48909,40205,45.12
2024-08-03,2024,Q3,49671,43742,43457,6214,12.51
2024-08-04,2024,Q3,45460,45359,42355,3105,6.83
2024-08-05,2024,Q3,69849,56241,47733,22116,31.66
2024-08-06,2024,Q3,93795,110033,45579,48216,51.41
2024-08-07,2024,Q3,76840,65307,44622,32218,41.93
2024-08-08,2024,Q3,77717,73004,47705,30012,38.62
2024-08-09,2024,Q3,85762,93897,49571,36191,42.2
2024-08-10,2024,Q3,38940,44391,47286,-8346,-21.43
2024-08-11,2024,Q3,43281,43279,43430,-149,-0.34
2024-08-12,2024,Q3,90644,74939,46994,43650,48.16
2024-08-13,2024,Q3,82498,95907,42832,39666,48.08
2024-08-14,2024,Q3,71866,69275,47122,24744,34.43
2024-08-15,2024,Q3,76930,90527,41919,35011,45.51
2024-08-16,2024,Q3,74786,65692,49603,25183,33.67
2024-08-17,2024,Q3,57171,61196,41745,15426,26.98
2024-08-18,2024,Q3,50807,53713,44529,6278,12.36
2024-08-19,2024,Q3,69605,81686,48546,21059,30.26
2024-08-20,2024,Q3,69629,74997,49349,20280,29.13
2024-08-21,2024,Q3,83719,92847,43785,39934,47.7
2024-08-22,2024,Q3,74714,77102,47253,27461,36.75
2024-08-23,2024,Q3,87782,71060,50129,37653,42.89
2024-08-24,2024,Q3,38418,41948,48062,-9644,-25.1
2024-08-25,2024,Q3,44730,42906,49239,-4509,-10.08
2024-08-26,2024,Q3,93817,98796,41630,52187,55.63
2024-08-27,2024,Q3,66995,67146,47732,19263,28.75
2024-08-28,2024,Q3,83000,93150,47495,35505,42.78
2024-08-29,2024,Q3,83525,88612,44881,38644,46.27
2024-08-30,2024,Q3,94345,101012,44397,49948,52.94
2024-08-31,2024,Q3,44510,43983,44763,-253,-0.57
2024-09-01,2024,Q3,42245,51670,50122,-7877,-18.65
2024-09-02,2024,Q3,79294,70537,42415,36879,46.51
2024-09-03,2024,Q3,82847,79911,48386,34461,41.6
2024-09-04,2024,Q3,73913,82172,45184,28729,38.87
2024-09-05,2024,Q3,64986,58946,47134,17852,27.47
2024-09-06,2024,Q3,78757,70972,49353,29404,37.34
2024-09-07,2024,Q3,39282,40456,42232,-2950,-7.51
2024-09-08,2024,Q3,47422,40413,49072,-1650,-3.48
2024-09-09,2024,Q3,75419,78781,47661,27758,36.81
2024-09-10,2024,Q3,76620,81313,48492,28128,36.71
2024-09-11,2024,Q3,60542,51809,49668,10874,17.96
2024-09-12,2024,Q3,68664,81926,60432,8232,11.99
2024-09-13,2024,Q3,63505,60200,48153,15352,24.17
2024-09-14,2024,Q3,36997,39778,82267,-45270,-122.36
2024-09-15,2024,Q3,49000,43752,47319,1681,3.43
2024-09-16,2024,Q3,79664,93764,41421,38243,48.01
2024-09-17,2024,Q3,77969,73368,46350,31619,40.55
2024-09-18,2024,Q3,66453,75374,48508,17945,27.0
2024-09-19,2024,Q3,82594,94281,47828,34766,42.09
2024-09-20,2024,Q3,82846,88565,48552,34294,41.39
2024-09-21,2024,Q3,35175,33398,45432,-10257,-29.16
2024-09-22,2024,Q3,36049,38462,49539,-13490,-37.42
2024-09-23,2024,Q3,60822,58172,49017,11805,19.41
2024-09-24,2024,Q3,66818,71498,45144,21674,32.44
2024-09-25,2024,Q3,64083,69696,47056,17027,26.57
2024-09-26,2024,Q3,60956,70351,44547,16409,26.92
2024-09-27,2024,Q3,62878,50972,45436,17442,27.74
2024-09-28,2024,Q3,43768,40669,42464,1304,2.98
2024-09-29,2024,Q3,36867,34645,46553,-9686,-26.27
2024-09-30,2024,Q3,80499,97958,41926,38573,47.92
2024-10-01,2024,Q4,69080,72337,41213,27867,40.34
2024-10-02,2024,Q4,76600,86664,46468,30132,39.34
2024-10-03,2024,Q4,78118,66056,44614,33504,42.89
2024-10-04,2024,Q4,66652,55670,47627,19025,28.54
2024-10-05,2024,Q4,41852,44732,48575,-6723,-16.06
2024-10-06,2024,Q4,35912,40913,48587,-12675,-35.29
2024-10-07,2024,Q4,99723,101989,48981,50742,50.88
2024-10-08,2024,Q4,67114,55153,47069,20045,29.87
2024-10-09,2024,Q4,79838,64074,43835,36003,45.1
2024-10-10,2024,Q4,86335,89486,41529,44806,51.9
2024-10-11,2024,Q4,66508,64987,45587,20921,31.46
2024-10-12,2024,Q4,52144,54416,47391,4753,9.12
2024-10-13,2024,Q4,35439,31440,43073,-7634,-21.54
2024-10-14,2024,Q4,75161,70037,44962,30199,40.18
2024-10-15,2024,Q4,76843,66202,49737,27106,35.27
2024-10-16,2024,Q4,62154,55498,43568,18586,29.9
2024-10-17,2024,Q4,78718,81914,45779,32939,41.84
2024-10-18,2024,Q4,67174,73999,49913,17261,25.7
2024-10-19,2024,Q4,44047,46847,44116,-69,-0.16
2024-10-20,2024,Q4,48338,42736,43607,4731,9.79
2024-10-21,2024,Q4,64444,78241,42235,22209,34.46
2024-10-22,2024,Q4,75075,80879,44294,30781,41.0
2024-10-23,2024,Q4,65860,52798,44012,21848,33.17
2024-10-24,2024,Q4,81376,89680,46147,35229,43.29
2024-10-25,2024,Q4,75176,69198,47622,27554,36.65
2024-10-26,2024,Q4,44675,42213,46946,-2271,-5.08
2024-10-27,2024,Q4,46600,44885,45117,1483,3.18
2024-10-28,2024,Q4,66317,78484,47670,18647,28.12
2024-10-29,2024,Q4,76433,62564,48146,28287,37.01
2024-10-30,2024,Q4,60224,51768,46363,13861,23.02
2024-10-31,2024,Q4,84958,90766,49771,35187,41.42
2024-11-01,2024,Q4,80543,81962,47289,33254,41.29
2024-11-02,2024,Q4,45554,41231,41174,4380,9.61
2024-11-03,2024,Q4,53045,64555,49515,3530,6.65
2024-11-04,2024,Q4,101189,82241,42647,58542,57.85
2024-11-05,2024,Q4,109473,93967,42325,67148,61.34
2024-11-06,2024,Q4,94080,85516,44194,49886,53.03
2024-11-07,2024,Q4,183236,205063,45520,137716,75.16
2024-11-08,2024,Q4,90239,110036,49869,40370,44.74
2024-11-09,2024,Q4,66399,79499,81801,-15402,-23.2
2024-11-10,2024,Q4,53245,44372,42808,10437,19.6
2024-11-11,2024,Q4,93950,78456,42511,51439,54.75
2024-11-12,2024,Q4,81267,83993,44719,36548,44.97
2024-11-13,2024,Q4,82268,88899,45113,37155,45.16
2024-11-14,2024,Q4,88735,85174,49059,39676,44.71
2024-11-15,2024,Q4,76917,75469,49338,27579,35.86
2024-11-16,2024,Q4,56081,58387,44954,11127,19.84
2024-11-17,2024,Q4,61397,58606,49162,12235,19.93
2024-11-18,2024,Q4,107183,98420,42092,65091,60.73
2024-11-19,2024,Q4,94250,101581,47303,46947,49.81
2024-11-20,2024,Q4,103201,98374,45546,57655,55.87
2024-11-21,2024,Q4,81149,79471,48111,33038,40.71
2024-11-22,2024,Q4,84725,92707,47561,37164,43.86
2024-11-23,2024,Q4,56602,51816,46508,10094,17.83
2024-11-24,2024,Q4,48232,41254,49594,-1362,-2.82
2024-11-25,2024,Q4,78828,64069,43906,34922,44.3
2024-11-26,2024,Q4,88073,87426,46989,41084,46.65
2024-11-27,2024,Q4,85976,80190,44029,41947,48.79
2024-11-28,2024,Q4,77365,82492,45419,31946,41.29
2024-11-29,2024,Q4,82368,95813,43887,38481,46.72
2024-11-30,2024,Q4,57720,64961,47879,9841,17.05
2024-12-01,2024,Q4,57202,55079,43026,14176,24.78
2024-12-02,2024,Q4,80319,84767,46465,33854,42.15
2024-12-03,2024,Q4,82579,93140,41791,40788,49.39
2024-12-04,2024,Q4,102745,119206,47691,55054,53.58
2024-12-05,2024,Q4,96153,89901,48903,47250,49.14
2024-12-06,2024,Q4,109138,109211,49428,59710,54.71
2024-12-07,2024,Q4,66306,63233,46580,19726,29.75
2024-12-08,2024,Q4,46267,48889,47445,-1178,-2.55
2024-12-09,2024,Q4,101212,121681,42619,58593,57.89
2024-12-10,2024,Q4,104782,98326,42788,61994,59.16
2024-12-11,2024,Q4,101666,120487,45267,56399,55.47
2024-12-12,2024,Q4,86838,78729,46151,40687,46.85
2024-12-13,2024,Q4,84380,66401,49179,35201,41.72
2024-12-14,2024,Q4,93293,96133,48629,44664,47.87
2024-12-15,2024,Q4,58928,53515,47551,11377,19.31
2024-12-16,2024,Q4,90794,93179,41630,49164,54.15
2024-12-17,2024,Q4,83666,96027,49983,33683,40.26
2024-12-18,2024,Q4,104737,111904,47920,56817,54.25
2024-12-19,2024,Q4,108199,114591,48569,59630,55.11
2024-12-20,2024,Q4,97328,112072,42529,54799,56.3
2024-12-21,2024,Q4,53578,59669,42765,10813,20.18
2024-12-22,2024,Q4,49512,50456,47022,2490,5.03
2024-12-23,2024,Q4,82100,79473,41741,40359,49.16
2024-12-24,2024,Q4,109674,125100,45919,63755,58.13
2024-12-25,2024,Q4,98144,88875,48658,49486,50.42
2024-12-26,2024,Q4,77048,66406,42410,34638,44.96
2024-12-27,2024,Q4,111831,127093,47832,63999,57.23
2024-12-28,2024,Q4,49816,49736,45166,4650,9.33
2024-12-29,2024,Q4,48735,40846,46839,1896,3.89
2024-12-30,2024,Q4,79276,72914,48748,30528,38.51
2024-12-31,2024,Q4,76304,71467,47094,29210,38.28
2025-01-01,2025,Q1,61049,72705,46493,14556,23.84
2025-01-02,2025,Q1,53804,62706,51566,2238,4.16
2025-01-03,2025,Q1,74748,87480,47154,27594,36.92
2025-01-04,2025,Q1,41156,35989,48399,-7243,-17.6
2025-01-05,2025,Q1,32316,38306,54763,-22447,-69.46
2025-01-06,2025,Q1,53155,44414,46858,6297,11.85
2025-01-07,2025,Q1,61199,68519,50182,11017,18.0
2025-01-08,2025,Q1,75765,66223,55387,20378,26.9
2025-01-09,2025,Q1,59374,58678,49532,9842,16.58
2025-01-10,2025,Q1,71734,74216,49580,22154,30.88
2025-01-11,2025,Q1,38898,43392,51216,-12318,-31.67
2025-01-12,2025,Q1,41372,46404,58854,-17482,-42.26
2025-01-13,2025,Q1,63332,51942,54546,8786,13.87
2025-01-14,2025,Q1,71133,60630,53779,17354,24.4
2025-01-15,2025,Q1,61979,53298,52889,9090,14.67
2025-01-16,2025,Q1,54862,61153,49641,5221,9.52
2025-01-17,2025,Q1,66089,66091,46954,19135,28.95
2025-01-18,2025,Q1,34483,28677,49558,-15075,-43.72
2025-01-19,2025,Q1,32872,34724,50099,-17227,-52.41
2025-01-20,2025,Q1,67708,52404,45964,21744,32.11
2025-01-21,2025,Q1,55643,47585,49630,6013,10.81
2025-01-22,2025,Q1,69412,63146,48444,20968,30.21
2025-01-23,2025,Q1,58158,48069,54946,3212,5.52
2025-01-24,2025,Q1,52633,51989,55197,-2564,-4.87
2025-01-25,2025,Q1,41355,41607,49443,-8088,-19.56
2025-01-26,2025,Q1,36425,34508,46412,-9987,-27.42
2025-01-27,2025,Q1,59788,51752,46433,13355,22.34
2025-01-28,2025,Q1,74487,63239,54726,19761,26.53
2025-01-29,2025,Q1,65795,56435,50236,15559,23.65
2025-01-30,2025,Q1,59100,72233,55024,4076,6.9
2025-01-31,2025,Q1,61200,55534,52160,9040,14.77
2025-02-01,2025,Q1,38454,39546,45598,-7144,-18.58
2025-02-02,2025,Q1,44064,34693,52238,-8174,-18.55
2025-02-03,2025,Q1,75592,65556,52229,23363,30.91
2025-02-04,2025,Q1,76631,80455,51496,25135,32.8
2025-02-05,2025,Q1,62655,52294,51644,11011,17.57
2025-02-06,2025,Q1,69446,72581,55409,14037,20.21
2025-02-07,2025,Q1,65712,75538,45510,20202,30.74
2025-02-08,2025,Q1,44045,51231,50389,-6344,-14.4
2025-02-09,2025,Q1,35260,29392,48921,-13661,-38.74
2025-02-10,2025,Q1,62994,78843,53052,9942,15.78
2025-02-11,2025,Q1,75259,89353,49023,26236,34.86
2025-02-12,2025,Q1,67063,71481,50525,16538,24.66
2025-02-13,2025,Q1,53337,51228,54204,-867,-1.63
2025-02-14,2025,Q1,76222,64539,52413,23809,31.24
2025-02-15,2025,Q1,32337,30946,53966,-21629,-66.89
2025-02-16,2025,Q1,40998,38399,50753,-9755,-23.79
2025-02-17,2025,Q1,55814,49233,49361,6453,11.56
2025-02-18,2025,Q1,52850,50035,47503,5347,10.12
2025-02-19,2025,Q1,62837,66839,46826,16011,25.48
2025-02-20,2025,Q1,76487,81162,53510,22977,30.04
2025-02-21,2025,Q1,56663,47732,53006,3657,6.45
2025-02-22,2025,Q1,33424,27986,46183,-12759,-38.17
2025-02-23,2025,Q1,37166,34209,47215,-10049,-27.04
2025-02-24,2025,Q1,62170,72196,47361,14809,23.82
2025-02-25,2025,Q1,64908,75643,49762,15146,23.33
2025-02-26,2025,Q1,72269,76944,47361,24908,34.47
2025-02-27,2025,Q1,54902,60397,52762,2140,3.9
2025-02-28,2025,Q1,51563,62332,50394,1169,2.27
2025-03-01,2025,Q1,51339,47500,55321,-3982,-7.76
2025-03-02,2025,Q1,50578,53806,45727,4851,9.59
2025-03-03,2025,Q1,86286,96722,47538,38748,44.91
2025-03-04,2025,Q1,85748,100042,49027,36721,42.82
2025-03-05,2025,Q1,90209,76661,55430,34779,38.55
2025-03-06,2025,Q1,90501,91979,48745,41756,46.14
2025-03-07,2025,Q1,75939,74925,49753,26186,34.48
2025-03-08,2025,Q1,51461,55317,54814,-3353,-6.52
2025-03-09,2025,Q1,40082,43622,45525,-5443,-13.58
2025-03-10,2025,Q1,87998,92769,51745,36253,41.2
2025-03-11,2025,Q1,85366,94569,53190,32176,37.69
2025-03-12,2025,Q1,91402,106263,53361,38041,41.62
2025-03-13,2025,Q1,84635,93288,54831,29804,35.21
2025-03-14,2025,Q1,72563,75682,54458,18105,24.95
2025-03-15,2025,Q1,38479,42682,45624,-7145,-18.57
2025-03-16,2025,Q1,48364,52063,47077,1287,2.66
2025-03-17,2025,Q1,81783,79138,49324,32459,39.69
2025-03-18,2025,Q1,77731,90391,52699,25032,32.2
2025-03-19,2025,Q1,69070,62931,46633,22437,32.48
2025-03-20,2025,Q1,76544,88094,53800,22744,29.71
2025-03-21,2025,Q1,66984,51623,53121,13863,20.7
2025-03-22,2025,Q1,48838,58483,45614,3224,6.6
2025-03-23,2025,Q1,50581,54435,51937,-1356,-2.68
2025-03-24,2025,Q1,90894,102166,49171,41723,45.9
2025-03-25,2025,Q1,66654,54430,55286,11368,17.06
2025-03-26,2025,Q1,93670,76684,48000,45670,48.76
2025-03-27,2025,Q1,91027,102957,46374,44653,49.05
2025-03-28,2025,Q1,79568,81147,49592,29976,37.67
2025-03-29,2025,Q1,47056,39858,54468,-7412,-15.75
2025-03-30,2025,Q1,54812,45689,48855,5957,10.87
2025-03-31,2025,Q1,64160,63129,46585,17575,27.39
2025-04-01,2025,Q2,80575,86461,49038,31537,39.14
2025-04-02,2025,Q2,68434,58124,46635,21799,31.85
2025-04-03,2025,Q2,66943,73616,50067,16876,25.21
2025-04-04,2025,Q2,94283,107456,47354,46929,49.77
2025-04-05,2025,Q2,56867,49236,51282,5585,9.82
2025-04-06,2025,Q2,52263,50598,51371,892,1.71
2025-04-07,2025,Q2,67441,62355,48917,18524,27.47
2025-04-08,2025,Q2,78380,94739,47910,30470,38.87
2025-04-09,2025,Q2,92072,108990,49374,42698,46.37
2025-04-10,2025,Q2,77740,66242,47529,30211,38.86
2025-04-11,2025,Q2,74062,60655,52585,21477,29.0
2025-04-12,2025,Q2,44573,38079,48218,-3645,-8.18
2025-04-13,2025,Q2,49170,55807,53498,-4328,-8.8
2025-04-14,2025,Q2,84680,90260,53559,31121,36.75
2025-04-15,2025,Q2,79805,63863,46562,33243,41.66
2025-04-16,2025,Q2,82917,70623,45539,37378,45.08
2025-04-17,2025,Q2,64148,60836,55105,9043,14.1
2025-04-18,2025,Q2,80880,71961,50096,30784,38.06
2025-04-19,2025,Q2,44179,40317,46164,-1985,-4.49
2025-04-20,2025,Q2,39303,37883,50332,-11029,-28.06
2025-04-21,2025,Q2,90978,102659,47618,43360,47.66
2025-04-22,2025,Q2,95793,112099,47641,48152,50.27
2025-04-23,2025,Q2,89993,101754,45409,44584,49.54
2025-04-24,2025,Q2,92266,71994,48427,43839,47.51
2025-04-25,2025,Q2,89332,86717,54682,34650,38.79
2025-04-26,2025,Q2,44531,38582,53929,-9398,-21.1
2025-04-27,2025,Q2,51230,50335,50177,1053,2.06
2025-04-28,2025,Q2,88724,84513,53083,35641,40.17
2025-04-29,2025,Q2,90737,82584,53987,36750,40.5
2025-04-30,2025,Q2,79827,71850,50078,29749,37.27
2025-05-01,2025,Q2,74894,86505,50540,24354,32.52
2025-05-02,2025,Q2,86672,95257,46425,40247,46.44
2025-05-03,2025,Q2,45803,45472,47406,-1603,-3.5
2025-05-04,2025,Q2,46523,52246,51178,-4655,-10.01
2025-05-05,2025,Q2,67429,54164,50005,17424,25.84
2025-05-06,2025,Q2,80988,73284,50907,30081,37.14
2025-05-07,2025,Q2,76701,73339,49808,26893,35.06
2025-05-08,2025,Q2,76240,86559,47269,28971,38.0
2025-05-09,2025,Q2,83438,80774,45862,37576,45.03
2025-05-10,2025,Q2,40611,47382,47766,-7155,-17.62
2025-05-11,2025,Q2,55345,59191,49320,6025,10.89
2025-05-12,2025,Q2,86133,83138,47412,38721,44.95
2025-05-13,2025,Q2,73215,56815,54510,18705,25.55
2025-05-14,2025,Q2,91282,94907,52228,39054,42.78
2025-05-15,2025,Q2,78566,94638,49673,28893,36.78
2025-05-16,2025,Q2,92200,82139,45458,46742,50.7
2025-05-17,2025,Q2,38419,44033,74863,-36444,-94.86
2025-05-18,2025,Q2,48485,40547,46306,2179,4.49
2025-05-19,2025,Q2,78483,90059,47953,30530,38.9
2025-05-20,2025,Q2,64433,61908,54345,10088,15.66
2025-05-21,2025,Q2,92869,92691,52272,40597,43.71
2025-05-22,2025,Q2,95316,110634,46787,48529,50.91
2025-05-23,2025,Q2,87712,102850,52863,34849,39.73
2025-05-24,2025,Q2,50663,62361,52202,-1539,-3.04
2025-05-25,2025,Q2,56799,56062,52204,4595,8.09
2025-05-26,2025,Q2,77353,90869,45774,31579,40.82
2025-05-27,2025,Q2,83595,81004,55118,28477,34.07
2025-05-28,2025,Q2,95023,96744,50060,44963,47.32
2025-05-29,2025,Q2,83961,87722,48265,35696,42.51
2025-05-30,2025,Q2,65310,60196,45896,19414,29.73
2025-05-31,2025,Q2,51076,39857,48890,2186,4.28
2025-06-01,2025,Q2,56291,60194,46226,10065,17.88
2025-06-02,2025,Q2,77324,76607,47566,29758,38.48
2025-06-03,2025,Q2,98972,103589,55106,43866,44.32
2025-06-04,2025,Q2,81031,75375,52203,28828,35.58
2025-06-05,2025,Q2,94452,80071,50947,43505,46.06
2025-06-06,2025,Q2,90346,95418,49149,41197,45.6
2025-06-07,2025,Q2,45167,43293,54783,-9616,-21.29
2025-06-08,2025,Q2,51272,49196,45638,5634,10.99
2025-06-09,2025,Q2,85216,95019,48408,36808,43.19
2025-06-10,2025,Q2,74880,76675,48316,26564,35.48
2025-06-11,2025,Q2,84583,69954,54179,30404,35.95
2025-06-12,2025,Q2,72325,83095,48721,23604,32.64
2025-06-13,2025,Q2,87347,77876,52823,34524,39.53
2025-06-14,2025,Q2,43359,36882,52823,-9464,-21.83
2025-06-15,2025,Q2,89735,100340,48493,41242,45.96
2025-06-16,2025,Q2,94609,76027,51446,43163,45.62
2025-06-17,2025,Q2,77591,79330,49833,27758,35.77
2025-06-18,2025,Q2,84640,104216,53844,30796,36.38
2025-06-19,2025,Q2,94382,109211,49718,44664,47.32
2025-06-20,2025,Q2,99212,101988,52835,46377,46.75
2025-06-21,2025,Q2,48365,53975,50329,-1964,-4.06
2025-06-22,2025,Q2,56974,47626,49642,7332,12.87
2025-06-23,2025,Q2,90260,71173,51862,38398,42.54
2025-06-24,2025,Q2,71900,87476,50076,21824,30.35
2025-06-25,2025,Q2,104957,102507,50432,54525,51.95
2025-06-26,2025,Q2,84149,70514,48906,35243,41.88
2025-06-27,2025,Q2,95574,104172,53047,42527,44.5
2025-06-28,2025,Q2,61589,64359,50115,11474,18.63
2025-06-29,2025,Q2,61826,68811,46664,15162,24.52
2025-06-30,2025,Q2,82652,85703,45812,36840,44.57
2025-07-01,2025,Q3,73798,64873,50162,23636,32.03
2025-07-02,2025,Q3,98861,105214,54429,44432,44.94
2025-07-03,2025,Q3,97004,89811,51527,45477,46.88
2025-07-04,2025,Q3,72965,81510,53834,19131,26.22
2025-07-05,2025,Q3,56997,56857,51143,5854,10.27
2025-07-06,2025,Q3,51480,45668,46993,4487,8.72
2025-07-07,2025,Q3,77168,80731,52100,25068,32.48
2025-07-08,2025,Q3,101843,95237,50869,50974,50.05
2025-07-09,2025,Q3,96095,113484,50361,45734,47.59
2025-07-10,2025,Q3,87075,82894,50991,36084,41.44
2025-07-11,2025,Q3,85448,77728,46147,39301,45.99
2025-07-12,2025,Q3,44730,40314,48695,-3965,-8.86
2025-07-13,2025,Q3,61718,56710,46044,15674,25.4
2025-07-14,2025,Q3,73032,77890,54752,18280,25.03
2025-07-15,2025,Q3,72394,75074,50107,22287,30.79
2025-07-16,2025,Q3,71455,65228,48732,22723,31.8
2025-07-17,2025,Q3,89657,102203,52046,37611,41.95
2025-07-18,2025,Q3,72966,89520,52447,20519,28.12
2025-07-19,2025,Q3,62959,75018,51533,11426,18.15
2025-07-20,2025,Q3,62232,53929,45718,16514,26.54
2025-07-21,2025,Q3,85589,81617,55152,30437,35.56
2025-07-22,2025,Q3,97631,110165,54031,43600,44.66
2025-07-23,2025,Q3,89847,75710,52370,37477,41.71
2025-07-24,2025,Q3,75249,76295,55263,19986,26.56
2025-07-25,2025,Q3,85765,68707,51293,34472,40.19
2025-07-26,2025,Q3,61001,68618,81726,-20725,-33.97
2025-07-27,2025,Q3,43858,36117,45800,-1942,-4.43
2025-07-28,2025,Q3,78997,73206,50185,28812,36.47
2025-07-29,2025,Q3,79206,80547,52771,26435,33.37
2025-07-30,2025,Q3,78154,88560,53224,24930,31.9
2025-07-31,2025,Q3,88944,82268,50434,38510,43.3
2025-08-01,2025,Q3,95233,97676,47411,47822,50.22
2025-08-02,2025,Q3,47108,50171,49113,-2005,-4.26
2025-08-03,2025,Q3,62893,68900,49933,12960,20.61
2025-08-04,2025,Q3,71588,64474,53697,17891,24.99
2025-08-05,2025,Q3,91863,95018,49237,42626,46.4
2025-08-06,2025,Q3,76891,71423,48435,28456,37.01
2025-08-07,2025,Q3,71314,77341,54660,16654,23.35
2025-08-08,2025,Q3,91201,98985,53718,37483,41.1
2025-08-09,2025,Q3,57641,60275,46460,11181,19.4
2025-08-10,2025,Q3,56558,67501,50032,6526,11.54
